strbuf_t|lifetimeFlagged
checkFlyAutoPathTarget|constraintsModernCentral
attack_rush_inited|omitToolsDerivation
addMapSprites|scopingAliasTwin
SpriteBase|addingRelies
ActionName|friendsAllocateUlong
showJoystick|mistakeHelpDestroyed
ActionTag|kindPatternNodefault
_afterDrawCommand|differencesExists
ByteBuffer|curlyEffect
m_setVisibleScreenCb|m_alsoGeneratesKnew
triggerPoint|m_guideAboveUser
maxcut_weaponeff_02|temporaryOrdianary
onRoleMoveFinish|flowsFriendsWhyouBehavior
maxcut_weaponeff_01|m_mutuallyScoping
maxcut_weaponeff_06|relevantIdentification
maxcut_weaponeff_07|m_processReady
maxcut_weaponeff_04|inefficientPrivatecopy
maxcut_weaponeff_05|differentInstantiateSome
IsLoadFinished|areaClosesIncrements
maxcut_weaponeff_08|m_typcanMoreovesome
maxcut_weaponeff_09|m_violateCeaseLogically
registerPlayActionWithChildrenCb|compilersSafelyAdditional
m_autoTime|m_plainDecide
md5_process|linkingPartnoExplaining
changeState|cerrResultsThroughCeases
removeRenderCallBack|qualifyingListsBest
TouchEnabled|triggerScopingExecuting
registerSetLocalZOrderCb|nodtorAdvancedIntent
stopInTheTime|booksChoseExploit
RockerDirection|assignBehindSees
maxcut_attack_04|supplyGranting
AsyncSpriteState|adaptorsParentheses
_cellSizeIdentical|basisException
MaxLineWidth|backCoveredPointers
addSpriteFrameListCallBack|attemptsForgotStrategy
maxcut_attack_03|m_coversPresumably
registerSetWhiteCb|wilreferKnowsInvolved
MAP_SPAN_X|m_isbnsPresumably
MAP_SPAN_Y|nonstaticPrecedingTypeids
registerSyncChildActionCb|strvecCurrentPushed
_FlyTriggers|pointerfifthBypass
m_ActorComponents|elemeisLabeledSafely
copulationNumber|freindLooksDisadvantages2
resetSpriteAct|nextAddsDiskReject
m_needLoadTextureList|rolesNamed
registerSetActorVisibleCd|actuasizeIdentifyApplied
inGroupCount|whenOptionalChose
m_ischecking|striparameterNumbers
retainMainRole|begunWilreferRevisited
convertRoleMovePosToMapPos|encapsulationSolveSketch
stand_inited|m_incrementallyPostfix
m_checkResType|m_exitRepeat
maxcut_attackmode_03|m_preprocessorCorrect
m_visibleState|m_predictCallpass
ClipboardHelper|placedPerson
isTouchInside|moreIdenticalOperations
m_showBloodAnim|m_partsLetting
m_syncPosMoveDistance|m_identifyModel
m_checkOpacityGap|m_emplaceIncrement
BlurSampleNum|literalSpecifiesIostream
updateTouch|behaviorRemovedAssuming
m_unselect_action|termsExpects
m_async_pvr_path|m_recentCallpass
TitleLabel|remainNumericTransactions
checkSuddenDistance|pointerBitsetheCompilers
m_boPhantomMove|resolutionTurnsDistinct
SocketData|recentlyViewRelative
m_renderList|argumentsThink
canShowNormal|pepperbyFetchClassclick
IndexFromPoint|streamViolations
autoPathFlyTargetPos|m_stoprocessingRepeatAsking
BaseAnchorPoint|appropriateMubeWorries
WsThreadHelper|employeeConstructAcross
m_zOrderFlag|m_resolvesLibraries
preAsyncLoadImg|andqueryFunctiwith
collideInTheDir|copiedMostPreferred
m_targetPosList|m_decrementsRuntime
playActionData|imageRevisedCaltoFront
registerAddTopHeadNodeToMapCb|readingAgreeGeneral
s_sendMsgBuffExEx|m_thfunctionResolution
AWC_setOnRide|worthNodefault
closeSocket|aspectsTreeRequired
m_mapScale|m_resourceManageDereference
stopMapAction|extensioindicating
removeWalkCb|ostreamSupportsUser
maxcut_weaponeff_03|m_somewhereBased
pushLongLong|providesSketchBehaves1
fly_inited|computeIntending
initDataAndFunc|modifyEntirePowerful2
removeSetLocalZOrderCb|reduceTyhaveGave
ScreenVisible|digitsParameteaWhat3
addSpriteFrameListAsync|circumstancesFilesInvalid
_indexFromOffset|copyingImplementationPast
performedAnimatedScroll|harderAppliesIncrements
magicUpToPos|parenthesesRelevant
scrollViewDidZoom|preferredThereRemains
onMoveSpeedChangeAction|moreIndicesTypeids4
OpenActionCheck|oftenNotifyManual
NowActByDir|mainHeadIdentical
m_screenVisible|m_constructingUnableIsbns
moveMonsterByPos|developedObtainPair
hurtKneelToPos|datsuchWhenDefinitions
removeSetOpacityCb|operationDesigning
SkillCtrl|applicablePropagatesStore
ODSocket|difficultDoeth
beginAutoAct|majorDestructorSequential1
stopMonsterByPos|matterAppliedStrcmp
WhiteCb|insteadCollideConsult
ShowHeight|oughtFreindBypass
m_scriptSelectedHandler|nearlyNaturallyMatches
m_currMode|roomWideBasic
m_isOpacAction|m_advancedDenoting
m_moverPoint|indicatesWilrefer
scrollViewDidScroll|namingVariousCccccccccc2
FullMode|understand
hasVisibleParents|fetchHavingSynonym4
removeResetDisplayCb|guaranteedFallThdefines
SHOW_STATE|relationalCalculates
m_needSyncPosToServer|m_equallyTakeFollowing
m_restoreFirstFrame|m_submatchSpecialize
changeStateWithChildren|versionsTransImageth
m_actorType|m_conversionchapter
m_playActionWithChildrenCb|resourceFourBuilt
getContainer|impactDetermineAddedStay
PlistNum|startStoplightZero
magic_inited|m_instantiatedRequiresCast
NeedSyncPosToServer|controlsPredicted
hideJoystick|hiddenImplementPointer
hasBlockAlong|convenientAssumeRecognize4
m_OnBodyComponents|reflectNontemplate
_m_stand_time|m_moreovesomeSuccessful
hasBlockPos|fileReviewEnumeration
isLoadFinished|findAlthoughOkay
beforeDraw|incrementingTargetCalto
addAutoRemoveAction|compilerStringsthe
loadPlistAsyncCallBack|concludesInitializing
unbindPlistAsyncWithEntryId|requirementBehaviorRecord
onUIThreadReceiveMessage|collectionSensible
reloadData|replacedInlinedTechniques
m_isAstar1Finished|m_validMatchedExecutable
registerFootprintsCb|recursionImagethSometimes
_vCellsPositions|drivenCopiedYour
IsResReady|neededForgetReturns
space2Screen|answerWordsMutually
registerSpriteInitCb|effectEliminatedReference
attackToPos|unequalParticularFreed
ProtocolPacker|comeRevise
loadMapStr|calculateArraysWhat
m_weaponEffectPath|m_devotedNeedsObjec
ShowPlistPath|printsGenerateSearch
_setIndexForCell|thanContaianyAffected
m_isAddRenderList|m_indicatesCheck
TouchEnable|reduceRecognize
showAllActionChild|rewriteSupposeparateValue
removeSetVisibleCb|compilationCerrIntended
CurrectDir|instantiatingBindRegular
WeaponEffectPath|yieldsOverloadBeginning
ParentReorderChildDirty|prvoidExtensioindicating
AsyncLoadPlist|chaptersHeaderDevoted
IsSystemFont|zeroFacilitiesGreater
MainRole|updatesPersistSpecifying3
_scrollDistance|m_delegatesWaysProgram
m_openActionCheck|whsuggestInttypPrecede
SpriteType|wantedConvertibleGroup
resetPosByHead|operateOptionalGuaranteed3
m_moveKeyPosCb|redeclareShownTransform
girdCellLongTouched|turnCompletesConstitute
OutLineSize|nearlyDealingReplacement
onBeforeDraw|becomeRewritesIntuitive
pushDouble|stateInheritSome
calculateOffset|importanceDealBound
SpriteDir|isbnsConstexprBuild
IsAddRenderList|invokesTheyLook
viewSizeSelfAdaption|forwardingDescribesUnder
m_showLayers|occasionallyErrormsg
removePlayActionWithChildrenCb|setsWhichLooth1
m_SocketState|m_operatorclickThdefines
HideWithChildren|storingRuleOtherwise
updateBloodAction|skipAroundStudy
ColorWrite|functiopresentedAssume2
registerSetVisibleCb|assignReliesSeparator
m_attack_mode|m_remainsPosition
_sleepCondition|instanceRecent
_componentOffset|instanceOperandIterator
updateNowAnt|expectationsVariadicMeans
removeActor|totalImportanceRest
hurt_inited_idle|m_loopAffects
m_showNameAndBloodState|actuasizeReferenparameter
m_addTopHeadNodeToMapCb|m_differContainTemporaries
applicationOnUpdate|specificationPropagates
m_touch_rect|disallowSuccessful
_remainTime|notingTchangeLegitimate
_updateContentSize|unwindingFindbookView
m_instance|m_worrySomewhat
loadPlistAsync|substringAbstractlyWita
BasePosition|reviseStringWhen
PetOnRide|salesWereTree2
walkInTheDir|existingLargerGrasp
HandlerMap|closeInefficientNest
AsyncDownloadManager|treatedCurlies
m_syncReplace|m_currentlyBlock
m_isLoadPlisting|destroyingTotal
ModeState|complicationEnableCover
SelectAction|codeFullyException
registerRockerCb|accessibleFunctionGoes
flyTmpHandler|m_indexInstantiates
md5_starts|nothingManualVarious
m_isLoadFinished|m_movesWhatever
m_center_node|m_exchangeOccasionally
numberOfCellsInGirdView|unusualOperatesConvert
YScrollView|fieldComparesImprovements
downloadFinish|possiblyChparameter
role_main_id|m_visibleThgenerates
SpriteNpc|tpreviousFullLegitimate
m_rocker_dir|employeeCreatingProgram
VisibleScreen|shownRatherInitially
m_roledata|m_interchangeablyNamespaces
m_suddenDistanceMin|m_stopsSupposeparateGroup
autoMoveShow|thenUnusualFairly
tile2Screen|consistsSubscriptPassing
rocker_loop|m_takingMeddleTimes
Effects|knewOverheadSupplied
BlurRadius|designersIndicateExcept
m_reset_display_cb|m_formOrganizeEquality
SpriteMonster|labelsPointRepresentation
SeedRandMap|techniquesReferring
SideTilePos|specifiesSetsSpecialized
_cellsFreed|m_pairsEfficiencyFacilities
FlagValue|wcouldCoverConstructors
registerUpdateTopHeadPosCb|aspectsWarrantConstraints
registerTouchDownHandler|facilitiesNewlineWhif
base_url_backUp|m_particularEyesAbstraction
MainRoledata|specializingGiveNodtor
createWithSymbol|buildsFactorial
m_scriptUnselectedHandler|explicitlyThemselves
createChain|functiocontrolBindingMore
deaccelerateScrolling|whtheSupportsMatrix
m_sprite_init|assigningUnderstand
m_speedPercent|m_soonHighest
m_touchEnabled|m_positionMismatched
m_isFinished|bindRelational
cleanPathByFly|insideArgumepassedAngle
m_repTypeId|handlesKeyword
m_blood_back|m_inferAppropriate
successCallback|multiplyingNumeric
createDownloadDir|documentationDefinitions2
m_isLoadTexture|elementsStunninglySame
ComponentByTypeAndId|valuesTellsProgramming
CLuaParam|likelyDescribeField
needAction|m_differencesDestruction
_moveCellOutOfSight|theareWithfifthAliases
OCC_FLAG|notingNeedsAvoid
FootprintsGap|neverPointsRequire
m_sendMsgCount|fullAllowsProvides
StandTime|threeLoopsOperatingMatter
maxcut_run|includedIncomplete
m_updateTopHeadPosCb|expectsSignalsGuaranteed
addSpriteFramePlistCallBack|determinesWitaProperties
OperateLayer|alreadyTextquery
sub_pecent|aggregateRange
InitMsgBuff|distinctInttyp
m_setLocalZOrderCb|m_rolesLiteralKnowledge
scrollViewDidStopped|meddleManageWord
m_phantomMoveFrame|insertUnscopedCompiled
initWithDataSource|neededExpectDesigners
PositionFromIndex|wordTildeNest
initDependTexturePathList|topicUndefinedparameters
_direction|accumulateWhichever
AttackModeWithChildren|nonreferenceCompanion
cleanAstarPath|controlSpelling
m_userOldMovePos|codeBinds
walk_inited|generatingCountsHandling
isTouchEnabled|hideAdditionNontype
removeActionChildByTag|hierarchyReleaseReady
MapOperate|lvalueTrivialIcase
MonsterId|oftenSurprisinglyAsked
removeAddTopHeadNodeToMapCb|whappearsCastCannotBookno
UnToAttack|postfixWordIntrinsicfifth
stoppedAnimatedScroll|operandsAndquerySuited3
AsyncDownloadState|startsContains
MapBackLayer|programRules
m_cellImageSuffix|m_operationsEncountersLike
PlistPath2|nothingFlagCould
AsyncDownload|booksRegardless
m_currActionState|findbookPromotion
VisibleRole|realizeFollowedPointed4
m_touch_enable|m_invokesPatterns
onSuddenFinish|alwaysAvoidClassesclick
GenerateMD5|compilationStillOverride1
relocateContainer|linkingAroundCmatch
addSendMsgCount|comparesReadsPlaced
removeAllHandlers|calcExpectationsAnother
_beforeDrawCommand|m_successfulPrecedence
space2Tile|inverselyThpositionComes
DataSource|spellingControlEnforce
loadSpritesPre|evaluatedCoveredUltimate
DefaultActionPlistPath|carsOnlyLetterWithout
autoMoveShow_ex|whichReplacesSections
checkCanWalkabledTile|initializingConceptually
update_pecent|placeProgrammersAssigned
LuaEvent|occursInteractsReturning
ActionEnable|distinguishHidesOught2
m_select_action|m_convertingFrontSection
syncPosToServer|thatVersusPrevented
setContentOffsetInDuration|nameMacroDestroyed
initMapData|preservingTestRelevant
_scissorRestored|m_inevitablyFollowing
updateMove|separatelyFoundAllocated
WeaponEffectPosOffset|afterExistOperation
ConnectNormal|minimizePromoted
maxcut_ride_stand|m_aliasWhsuggest
m_setActorVisibleCd|m_thoseReallocatesResource
main_sprite|m_reliesTypeManual
removeGotoDeathCb|declaresAvailableArray
registerSetPositionCb|debugdeleteWillAlways
ride_inited|m_patternsDelegate
ResetDisplayGap|advancedImpactHandled
m_mapTextureList|m_succeedsFound
SpritePlayer|assumeApproachEmbodies
ActorRenderType|helpfulLarger
m_blockStr|performanceInstantiates
textureKey|failVeryBetween
removeHandler|opposedExternfifth
__indexFromOffset|exonlyUnrelatedDeduce
createBaseWithCache|waysOutputWhether
m_onloadPlay|involvedPrevents
flyInitPos|constructorsReduce
moveMapByPos|genericCompletes
attack_inited|causeValueduring
AWC_attackMode|programmersRangeFocusMost
m_isLoadTexturing|m_dynamicallyThat
DefaultMapView|findShouldAccessed
ActionHide|exhaustedReferenceIntend
sendPointsByPath|unnamedAttemptsPurposes
IndexFromGroupAndInGroup|transformationFlagged
cleanAsync|hierarchyPointDynamic
BaseUrl|ordinarilyUpdate
SpeedFloatPercent|unnamedWhereIobj5
AWC_changeActionState|algorithmWorksBraceAend4
m_actionOpac|attemptsCollections
gotoRevive|errorsMimicScope
UnSelectAction|assumeManageLittle
m_spriteInitCb|m_nothingSelected
checkPlayDefaultAction|expansionManyQuiza
removeSyncChildActionCb|unlessSupplyTreated
LuaEventManager|senseGrades
m_syncActionCb|m_assumesEncapsulation
MainNode|coverIncrementsDenoting
m_suddenDistance|constitutesSupplies
onSubThreadEnded|specializesThumb2
md5_context|reflectSets
SpriteBlur|predictedReverseWhich
_entrySeed|machinesIndicesInfer
registerWalkCb|existLettersPermitted1
m_baseOffset|m_enforceBitvecParts
m_actionOpac_c|destructorsAlternatively
addRenderListCallBack|numbersCeaseListed
ThreadSendMsg|moreovesomeStrategy
removeColorGray|chapterEqually
MapSize|notedFreesChartyp
m_restTime|allocateConsists
resetDisplay|incompleteElementsStorage
ActorActionManageC|mubeReplacement
move_speed|m_encloseProvide
start_tile|m_heightIndicesSimplify
readThread|stillIndependentlyArgs
FlyModeValue|promptLookupWrotePosition
m_stepTime|m_declarationsReflectIntent
checkMainRoleTile|theyKindsFundamental
fixMapPosOffset|dynamicallyOverAffects
m_smalltobig|m_objectsEntireThexercises
m_beginPoint|blobptrShorttypDirection
m_base_cache|simplyCircumstancesPrints
updateCellAtIndex|failAheadRemain
_touchMoved|m_positionsSupportEvaluates
m_needLoadTexturePathList|numberedGrades
initMagicStatus|assumingFirstGenerally2
CMD5|releaseObtainIntent
FlyModeWithChildren|overloadedTellMenu
removeCellAtIndex|respectiveTellChose
CacheNum|istreamFlowsGrading
AWC_stopInTheTime|descriptionKnowsShow5
getViewRect|pscreenInheritance
JustDelayCheck|harderReferencesthLooking
initRunStatus|processingNumbersSource
m_plist_num|m_operatesRange
restoreMainRole|curlyAmongEvaluating
MsgBody|factZeroCopying
m_touch_move_cb|m_cabePointers
YGirdView|skipRepresentation
m_asyncEntryIdList|m_reversesSoonVectors
ColorGray|compareisbnRuntime
BigValue2Host|overrideEnsures
CurrActionState|specializedComplication
m_sDirectoryName|enclosedOnce
SkillPhantomMoveEffect|leftBeganAppear
checkVisible|priceOperationLike
LUA_YGirdViewDataSource|occasionallyPrvoid
UserOldMoveMap|declarationsBracketTrying
changeRePlayTypeAndResId|scopeMemberOperateActs
MainRoleId|fragmentSynthesized
m_actionStateChange|m_timesNonexistent
MapSendByte|exerciseActionsHoldEnums
changeFullShortMode|stopsPrimaryBetterLinkage
m_FatherType|scopingReuseBegun
_plsitInfo|leaveComputeReset
initAttackStatus|promotionBound
_callBackList|m_occurrenceNonexistent
YGirdViewDelegate|strblobConstexprAlthough
PrintPosError|hidingBeforeConverted
OpacityCustom|supportedComputingRemoved
m_blood_bg|pastReusedBookstore
removeActionChild|everythingExploitImplicit
m_needReleaseFrameList|m_threeLimits
tile2Space|applicableInstances
_isUsedCellsDirty|equivalentthLeftDirectly
updateAllAddMapId|followLargeLabeled
playStandEffect|inverselyStoredSection
m_defaultFileName|m_specificationNone
_touchLength|quizWhichever
addMoveTarget|greaterFunctiwith
m_versionChannel|destroysLeadsFamiliar
initWeaponEffFrames|complexityTogetherForm
onSubThreadStarted|bracketsTokensSeparates5
checkMapCellIsDownloaded|doethSelectsExamines
TimeLabel|librariesOtherRewrites
DirByDirection|focusDefaultsCurlies
SingleVisible|compilerStoprocessing
waitCloseReadThread|designsInstance
MapRecvByte|doethConventions
addHandler|arraysGiveVerifies5
m_showState|m_updateSimplerLetting
EncodeBuffer|keywordGivenNeither
m_blood_pro|builtAllowStructure
ComponentAttrsByTypeAndId|separatelyJustPeople
checkCanWalkabled|followThumbSeveralIntend
startRocker|relativePersistDecrement1
CurrentActionState|collideDestroyedItself
AsyncSprite|limitEscapeBackslash
MenuButton|ideaDelegates
fixAnimDir|remainsDifferenbetween
HostValue2Big|correspondsAdvantage
maxcut_attack|m_isfifthPriceImportant
callBackAction|westoreWidthTypes
isDownloadingOrJob|relatedEmptyTakingAlegal
m_renderListEntryId|m_suitedIndicateVarying
m_suddenCheckGap|m_smatchWere
addCacheSprites|preciseHandlingSpecifies
maxcut_hurt_idle|choiceArticlesSoon
m_isAutoMove|periodAddedFall
insertCellAtIndex|meanLeaveChartyp3
isTouchMoved|opposedShouldThumb
addCallBack|pointerfifthAssignment
m_load_all|returnsLetsOrdianary
_asyncRefCount|m_firstExistsBooks
m_setPositionCb|m_allocationNonmemberColon
LuaSocketState|recentRelies
IsFixAnimDir|averageIdentification
m_cache_anim_List|m_lvalueSubset
AsyncFileOp|muchUlong
LoadALL|resolvesEscapeTest
ResLoadStatus|thoughHighSure
VersionChannel|concludesSuspendedNever
VisibleState|lookupRecompilingVector
CplusShowMsgID|bracketsBodyResulting
applicationOnExit|performanceRelySolve
m_is_system_font|m_attentionInstantiations
removeRockerCb|appropriateAreaDetermine
stopMoveAction|leastInspiredThing
maxcut_attackmode_10|stoplightPassing
maxcut_attackmode_11|m_reasonWrittenElemeis
maxcut_attackmode_12|m_initiallyGreatly
SendBufLen|iostreamArgumepassed1
m_setVisibleCb|numberedNormallyElemtype
OffsetPos|deductionNeverBehind
AWC_playActionWithChildren|lookProvidedDestroys
BloodVisible|closeAbstractlyLookup
girdCellTouched|transformationExpanded
m_TopComponents|m_worryNonstatic
LuaSocket|andqueryApplies
NameAndBloodShow|inefficientBeginning
moveMapByPath|primerPdataReady
m_curTargetPos_tile|m_turnFlagged
m_footprintsMoveDistance|appearsPushNext
checkFlyPath|becomeThemselvesMaking
SmallToBigMode|passedDeclaringPurposes
m_move_direction|m_enforcesKids
m_footprinsOpen|parameterAnglePrefer
ConnectIpv6|treatedArraytheEnumerator
IsOpacAction|defininsideWideThink
AsyncCallBackInfo|betterAbstraction
ZOrderFlag|iandRelativeAssigns
removeUpdateTopHeadPosCb|highestHavingSubsequent
_requestMutex|assumedDeduction
syncNameAndBloodShow|nestingMatchedLess
screen2Space|lastLevelImage
resetSpeed|worksBraceRefers
m_swallowTouch|shouldCastConfusion
m_resReady|separatesSmatchProcessing
addCacheSpritesPre|overrideRecursiveDeclares
maxcut_fly03|unlikeNearlyLegal
ViewSize|dereferenceAppearGave
DefaultMapBackLayer|machinesOkay
NearTiled|insideOperandsWhat
Direction|multiplyingTarget
LuaMsgBuffer|yieldsAnswerAlways
changeMode|resideScopedWithin5
MapScale|recentlyIsbnsInput
ProtoBody|letsFunctionfunction
excavateToTheDir|occurStatementDimension
m_actionHide|m_whversionConventionsNeeds
addRenderListCallback|linkDisallowBitset
m_thread_quit|m_booksInevitably
hurt_kneel_inited|m_hiddenRefersInitially
removeSetVisibleScreenCb|tuplesCandidateTopics
Commen_Direction|accessedIntroductory
ActorType|templatesStartTuples
AsyncStruct|m_attemptedFacilities
FollowNode|orientedLargerEnds
CenterNode|currentlyDeclaration
Touch9Sprite|refersEnums
moveInTheDir|reasonsHaveBecause
m_rocker_direction|m_letsIstream
m_managerInitNum|m_fullyLarger
_cellsUsed|m_convertAllowedAbsolute
removeSetActorVisibleCd|functionalityThrows
m_components|timeReferenparameter
initDeathStatus|mimicTableBookstore
setViewRect|copiedIntrinsicfifth
maxcut_stand|intoBindingReallocates
onAfterDraw|familiarUnnamedThposition
DownloadUrl|variablesArrarecallCursor
IsConveyAction|operatesTriesConstitute
SpeedRate|warrantWhtheState
m_isLoadPlist|m_attemptParametethat
hideAllActionChild|attentionCompiled
updatePosition|doubleprecRuleUnnecessary
pszFileName|m_unwindingOnalthough
PathByPos|formComparingDirection
initFlyStatus|overrideControlProhibit2
_AppMsgFlagTo|parameterSeriesPreserve
AttackNum|majorSupplyCoupled
isDragging|whsuggestSharedWhappears
syncSendStateWithChildren|lettingPreventsAkinVersus
playAction_ex|incrementallyComplicated
m_loadTextureEntryId|m_memoryAbstractly
m_actionOpacGap|m_addsNumber
m_unAttack|tyhaveThumb
targetPoint|preventsCopiesWide
YGirdViewCell|abstractNines
maxcut_ride_run|occasionallyAlways
m_farLength|m_resourcesEquality
DisplayMap|linkageUpdatesShared
addTextureSprite1|queryresultMadeFactLocal
m_beginNode|m_readsIncludeEscape
_blurSampleNum|handledChosen
numberOfCellsInGroup|implicitConvenientDefined
m_sleepCondition|happensSearchDefined
ActionWithChildrenType|resetEmpty
m_map_allAdd|m_learnedPresence
addPhantomMoveEffect|rememberLoothIath
m_stand_times|m_coutIdentical
initHurtKneelStatus|noteArrowPrints
suddenToThePos|discussioofListsHaveWhyou
_successCallback|inputFunctionalReused
m_time_label|essentialMimicAbsolute
m_rotateDrct|m_thereNonextern
_needRelocateContainer|m_valueViceOptions
LeftTime|unusualPredicate
m_justDelayCheck|m_failOkayDeduced
rocker_loop_max|m_fileTurnsSemicolon
registerDownloadSucCb|pathEncloseAllowEmplace
AsyncJob|loothWhyouReferencesth
m_touchType|m_bitwiseInversely
m_auto_clean|m_userPromoted
_deltaTimeTmp|takeIsbnVersion
initRideStatus|thumbLimitationAcross
_selfAdaption|interchangeablyThcall
_container|m_protectionCorrectlySoon
MsgBodyLen|iostreamExpectPrinting
_AstarNode|rightItasSuccessful
ActorFlag|inadvertentlyFragment
actiontime|m_nonpublicOwnsFunction
death_inited|m_indicateLiteral
AWC_flyState|shownRestrictedThroughout
m_allShowWithoutCheck|stunninglyWithfifth
PlistsNum|operationAssumeFriends
maxcut_weaponeff_10|alegalDecrement
FlyMode|programmingQualifying
m_offsetPos|m_preservingGreater
maxcut_fly01|digitsExtensioindicating
maxcut_fly02|m_becomeReading
m_curTargetPos|settingIntendThere
m_resSuffix|m_colonStoplight
registerSetOpacityCb|printedClosePeppers
registerSuddenCb|basicsDrivenRandom2
playAction|bitsManyUnlike
SpriteGuard|complicationAproblems
FontChina|iathRest
EntryId|conditionChainDoesndiffer2
print_storage|explicitlyStackDetermine
updateJoystick|expectCloseFriendship
m_footprintsGap|validWidthPrvoid
resetDisplayGap|m_debuggingIncludingEasier
_asyncStructQueue|m_usuallyManager
_addCellIfNecessary|equallyCreatingCome
playerAttackToPos|thfunctionFamilyCombine4
stopRocker|supplySerialMembers
MainSprite|representExpands
syncKeyPosToDetailMap|incrementingPurpose
ActionStateChange|embodiesSolveReplaces
CenterItem|realizingMakingEnough
groupCount|unnecessarySometimes
ShowTag|mismatchedCharbits
LuaEventExEx|runningPrimerIntent
Commen_ActionToDo|soonAlongMemberwise
sendPointsByAstarPath|striparameterImportance
initWithFileExt|collectionsAllocateReport
ActorRenderQueueManage|stackSoonOrdianary
m_pszFileName|redefinesBetweenGrasp
registerTouchUpHandler|rationaleAlternatively
_progressCallback|isbnFreeThingFiles2
popLongLong|highInheritanceSubset
doStreakToTheDir|occurrenceTightlySignals
s_sendMsgBuffEx|affectedBindLimitation
OnRideId|primaryFactIterator
flyTriggerList|increasedState
initCheckFlg|asfifthSignatureSetting
m_OutsideBodyComponents|involveHidesDetermined
removeComponent|leadsDoesndifferRest2
m_isActive|m_factorialToolsOmitted
YGirdViewDataSource|allowContrpassesExplain
registerSuddenDistance|chparameterSpecification
VisibleCustom|techniqueGenerates
YScrollViewDelegate|giveRtti
_blurRadius|m_plainEnumeratorsCare
MapView|imagineUnlikeNeed
ActorId|rankedClauseHowevewe
flyToTheDir|whateverEvaluatesDerived
calculateAssetPath|simplifyDestroyingLearn
m_fly_mode|happensView
_parentScissorRect|m_conventionConsider
m_monster_id|m_compiledConverted
loadFlyTrigger|fullyOrdinaryTimes
TouchType|greatlyCollideWhen
initAttackModeStatus|specifiesSignals
m_loadPlistEntryId|typesThosmembers
removeSetPositionCb|whappearsSensibleOnce
DecodeBuffer|consultPepperbyCharbits
MakeNumbers|qualifyingUsually
pushDataByString|validEssentiallyNearly
attackOneTime|waysExonlyBackslashNever
dir_next_tile|m_convertingSameHowevewe
NameLabel|bookstoreWillConstant
m_numsCache|m_meaningAlternatively
SendMsgCount|safePropagatesItemFocus
ManagerByState|iobjBoundthatSwapped
LuaEventEx|specificLanguageSensible
m_show_plist_path|m_openAdaptors
ShowTexturePath|parametethHenceStarting
m_center_pos|m_forcesOmittingType
LUA_YGirdViewDelegate|promotedAlternatively
girdCellAtIndex|flagMeddleJustDeclaration
m_suddenTargetPos|normalExpandedIncluding
FootprintsOpen|implicitlyCompatibility
createToTheDir|othersBecauseAbstraction
TileByDir|shorttypOrdinaryOught
moveMapByTouch|initializtheTookEven
CenterPoint|beenStrcmpTempting
AttackMode|patternResultNodefault
updateShowState|recognizeBitsOptional
m_name_label|m_serialThrows
GroupAndInGroupFromIndex|specifiedPassHandling
registerGotoDeathCb|randomItasContaiany
IsFinished|happensDifficultSystem
_m_touch_time|usesProperly
registerMoveKeyPosCb|sequentialWhatDeleter
systemMoveRoleToPos|wmustInitializationsSafe
MapSpan|encloseEqualsResetPrecise
ShenbingStatus|gaveObjectsthBasic
addTextureSprite|gradingSyntacticFlipHere
scroll2Tile|contextNameEnumeration
removeSuddenDistance|builtAskingInstances
digToTheDir|informationDefineSees
m_delaytime|dimensionChosenOmitted
ShortMode|positionedFamiliarStore
DirByTile|debuggingRespective
ActionState|pushBoundthat
checkMovePos|givesPushCacall
DirectionByDir|imagefifthCompilation5
StFPSlog|haveSaved
_responseQueue|listthFinds
m_showNums|oftenNothingUnderstanding
onSubThreadLoop|objectHighestFront
DisplayStatus|browsersActsLiteralsBasic
m_noMove_cb|m_noteDigits
OnRideWithChildren|preserveMeddleAccustomed1
AttackModeC|specifiesJumpingRecent
m_setOpacityCb|m_dataSeen
m_setWhiteCb|hasptrHelp
initAttackRushStatus|parametisAllow
updateOpacityAction|loopProvideView
m_showMsgID|unlikeCentral
m_speedRate|m_elipsisStudentSpecifed
ShowLayer|designerRvalueAbility4
maxcut_attackmode_09|allocationSimilarly
maxcut_attackmode_08|semicolonNormal
maxcut_attackmode_07|m_onbitsContentColon
maxcut_attackmode_06|m_cabeBuildsBinds
maxcut_attackmode_05|m_cannotResponses
maxcut_attackmode_04|copyingPassing
DirIDByDir|parenthesesPromotion
maxcut_attackmode_02|m_parametethatNotify
maxcut_attackmode_01|m_exerciseZero
TouchSprite|bookstoreEmployee
m_center_item|m_confidentUnlikely
BloodType|preciseSeparatedPscreen
calculationArrival|separationDistinctEnsure
HandlerType|stoppincondition
m_downloadListenerList|m_seriesHappen
runLuaFunc|consistentExclusiveKnow
checkMapIdInAllAdd|forcesUsersGeneric
m_plist_loadnum|m_sizeAttempt
errorCallback|m_bodiesConstraints
s_sendMsgBuff|addressDefines
showNameAndBlood|bitsetsKnewAlgorithm
m_petOnRide|m_operationsConverts
m_viewRect|theseAdaptors
m_nameSize|m_averageIncidental
SuddenSpeed|pairOstreamWita
s_recvMsgBuff|forcesFour
_objAttrs|completelyInfrequently
hurt_inited|m_fairlyInitializersNeeded
DirByNowPoint|needsTreturnDeclaration
NameSize|callpassSpeakMimic
m_sudden_cb|m_realizingProblemsWorry
_requestQueue|m_pscreenRecentlyDifference
_DisplayNode|completesEven
_responseMutex|m_theareCopies
addComponent|nonexistentAccessible
MaxReadCount|functionalityJustAlready
m_managerList|m_siteSerial
progressCallback|m_priorSaved
AWC_setActionStateChange|drivenSimplyPreserving
doOpacityAction|failsQuizaMistake
m_auto_clean_cache|m_factReside
copyMainRole|possibleSurprisinglyOlder
insertActionChild|underlyingUndefined
removeSpriteInitCb|parametersunlikeRemoved
ConveyState|expressionasInvolveCode
girdCellHighlight|hidesKnowPreserving
m_random_mode|m_implementsThird
cleanOtherActor|identifiesRepresents
sendSocket|updateSelectsButton
_errorCallback|executesRunsTransactions
md5_finish|enumeratorsChangedAllowed
run_inited|surprisinglyThrough
cellSizeIdentical|appeaanywhereSynthesizes
m_shenbingStatus|m_elementsEqualsAspects
convertMapPos2EdagePos|bestViolate
md5_update|unnamedBehalfTechnique
repSpritUrl|iostreamWhere
m_componentsAttrs|m_instantiationsNothing
AppMsgHead|readsIsbnsPattern1
m_start_point|dimensionVaries
isactor_flag|disallowResult
maxcut_weaponeff_11|omitDesigningSplit
playActionWithChildren|elementPredicateCompiler1
m_isFixAnimDir|m_expandsBrace
auto_download|m_facilityRepresented
maxcut_magic|interactionEnumerator
m_isAstar2Finished|doesndifferViolations
m_suddenSpeed|valueExceptionsAndquery
m_show_texture_path|theifOfile
PageIndex|shownPointerPassed
registerTouchMoveCb|headActuallySchema4
removeSetWhiteCb|matrixExecutingCompilers
m_conveyState|printedTypeidsSees
addTopHeadNodeToMap|examinesStatementResults
m_is_right|m_parametersunlikeWith
m_setWhiteComponents|m_synthesizedLimited
LuaBuffer|areaArgumentobjects
girdCellUnhighlight|pointerlikeTrying
_loadingThread|m_includesAccumulate
m_onRide_id|m_intuitiveDecrements
m_followNode|m_completesRather
shadow_sprite|m_withoutRise
asyncEntryIdCallBack|calculatesDimensionAlong
m_isInRenderList|lettersLinkage
m_syncPosGap|m_highestUpdate
_m_move_time|m_currentTopics
registerResetDisplayCb|undefinedparameters
openSocket|destructorDoesSplit
ShowBloodAnim|elsewhereImportanceStores
m_pszFileNameList|m_calcSignals
_cellsInGroup|primerCauseMake
_objRender|submatchFollowing
BtnContainer|ableSometimes
PageByIndex|shakingMakingColor
findTriggerByPoint|usersEnumsShorttypWorth
m_gotoDeathCd|relationshipPointerfifth
m_checkOpacityMoveDistance|m_showTuples
_indexFromOffsetInGroup|sequencePrecedingSection
syncFlyStateWithChildren|introductoryCmatchFollow
DirByNewPoint|matchSaysValuelike
_updateCellPositions|howeveweResultsTwin
m_suddenCheckGapMax|m_compilationBoth
removeTouchMoveCb|unorderedOverloaded
updateZOrder|buttonStatementsDoeth5
cleanDenpendFrames|preventsSalesNesting
maxcut_hurt_kneel|m_initializationAround
maxcut_weaponeff_12|m_agreePrintedCould
hurtIdleToPos|rewritesRedeclareLooth
AutoInfo|testCallableSpecifiers1
registerNoMoveCb|conventionFollowUnscoped
AWC_flyMode|earlierCreateFrom
m_actiontime|m_qualifyInitially
LabelChild|findbookRequested
removeMoveKeyPosCb|occurrenceMimicPart
initHurtStatus|implementingAllocateIndex
initHurtIdleStatus|olderDetailIdentifying
initGLProgram|destructionOwhichDeletes
_touchPoint|m_processOfferFamiliar
addWeaponEffect|representsTightly
stopMainSpriteAction|removedDetailsKids
registerFlyCb|employeeResulting
createEffect|neededCoversInstantiating
m_isBloodVisible|m_typcanPrevious
initStandStatus|nonexternTakingDeal
maxcut_death|initialBooks
FatherType|friendsSimplifyDeleter
AsyncPvrPath|ruleImagethThposition
AWC_conveyState|mostWorthIndicating
m_actionOpa_state|m_subscriptUpdateLookup
LabelNodeC|stackInput
OutLineColor|callSerialWestoreChoice
m_title_label|m_surelyClear
removeFootprintsCb|defininsideThathey
roleMoveOnMapByPos|programOperatesListed
MoveDirectionUpdate|pdataDifferingOperands
IsRepMode|memberEscapeHowevewe
is_getData|m_linkWork
unbindPlistAsync|pageDeclaredLettingInsert
MOVE_CHECK_GAP|differenceAdvantages
girdCellSizeForIndex|hasptrConstitutes
initWithViewSize|presenceGreater
scroll2Pos|unwindingAverage
registerSetVisibleScreenCb|relativeEcmascriptBuilt
maxcut_hurt|m_warrantFindbook
RestoreFirstFrame|smatchIllustratePoint
addColorGray|usedWithinOwhichCondition
GraySprite|appliedDifferenceNoted
screen2Tile|actsWishQualify
girdCellWillRecycle|howeveweFlaggedPostfix
PlistPath|changingNeitherWhose
m_footprintsCb|qualifyingDifferently
ThreadLogFunc|incrementallyOperations
m_boSkillEffect|m_creatingGenerating
m_customlistener|m_castTightly
m_downsuc_cb|m_styleLeads
MsgID|unequalSquares
_plistInfoMutex|currentTellCovering
