checkbox|bitwise
juedouchang|specifies
zhuanzhi|interaction
mission|expectations
cocos2dx|always
welfare|indexed
Progress|shows
skill|cast
EscortTask|moving
layers|versions
loading|textquery
group|overall
noticeBtns|deallocating
worldBoss|structure
title|example
pray|inspired
leaderboard|fixed
newFunction|complexities
window|surely
tabTitle|understanding
mail|sense
team|intuitive
achieve|wmust
fabaoplist|points
itemIcon|especially
xuewumudi|built
crossService|their
tuto|recognizing
petMount|oriented
scalable|adds
functional|initializers
util|mutually
skilleffcets|able
tujian|bound
effectsplist|submatch
particle|enclose
button|cleans
fonts|enumeration
guard|corresponding
resNew|when
bag|attempt
rune|thus
common|errormsg
arrow|deduction
activity|ability
pools|owhich
tranSport|reasons
pvp|istream
map|pscreen
Pet|thing
npcAudio|generally
Label|first
baseplist|override
download|relational
home|omits
transport|ostream
scale|printing
timeToTonic|loop
res|involve
rideplist|alegal
npcplist|referencesth
progress|encapsulation
net|separator
syncReplace|contents
notice|reallocates
bg|objec
monster|path
dropRepIcon|declares
mainui|numeric
component|asfifth
mapsecond|says
skillicon|does
base|kind
boss|aproblems
newEquipment|withfifth
zhuanZhi|another
src|differing
showplist|hidden
flg|evaluated
login|ending
wuqiplist|specified
compose|limits
juewangshamo|error
block|answer
expBall|cars
answerActivity|point
number|promoted
young|embodies
vip|pointed
sounds|naming
serverlist|unrelated
equipSys|worry
market|printed
plot|signature
lottery|reading
mapMusic|aggregate
transform|disadvantages
strategy|instances
zhengjiukaien|changing
escort|never
friend|introductory
head|determines
wingplist|constructing
activitys|realize
artifact|forget
selector|confused
task|fairly
quick|okay
line|array
buffQiPao|copied
mk|made
marriage|correct
store|accustomed
msgNode|redeclare
showName|problem
xieedongku|nonpointer
rename|checks
chat|whole
transfor|definition
currency|relying
scrollBar|soon
createRole|dimension
tab|partial
tianjiangmohe|curly
partner|designed
configOp|whis
messageBtn|instead
pay|cmatch
setting|declarations
role|linkage
res_new|then
top_icons|ellipsis
config|possible
rwfbshxn|separates
buff|solution
roleplist|knows
faction|operation
welcome|calto
redpoint|assigned
fb|doubleprec
nainiuguan|address
blood|execution
brotherhood|initialize
Login|reverses
achievement|listed
icon|focus
refine|converts
daily|enforces
face|harder
xinshoucun2|contract
shaders|certain
