strbuf_t|allowsGoes
checkFlyAutoPathTarget|designingStaticsCollide
attack_rush_inited|m_destroyedChosenDepends
addMapSprites|readyFrameworkContext1
m_isAstar1Finished|m_longerStore
ActionName|directionDocumentation
showJoystick|nearlyStoprocessing
ActionTag|positionedWant
_afterDrawCommand|m_describesMatchedFunctions
ByteBuffer|advanceIobjFails
m_setVisibleScreenCb|nonvariadicHandled
triggerPoint|whversionParts
maxcut_weaponeff_02|trivialPrints
onRoleMoveFinish|confusionAreaEnforce
maxcut_weaponeff_01|replacesReferred
maxcut_weaponeff_06|m_remainingName
maxcut_weaponeff_07|m_patternDiffers
maxcut_weaponeff_04|computationalStarts
maxcut_weaponeff_05|sureSurelyDriven
IsLoadFinished|chainVersionAssignment
maxcut_weaponeff_08|m_multipleCompiledSays
maxcut_weaponeff_09|referencesMeanComplex
registerPlayActionWithChildrenCb|pairwiseOpenPoint
m_autoTime|m_alsoContaianyExtended
md5_process|distinguishSimilarlyOften
changeState|executeInaccessibleSeen
removeRenderCallBack|transformationCurtok
removeActionChild|statementsEasiest
TouchEnabled|applicationsMemberwise1
registerSetLocalZOrderCb|variadicClosesCerr
stopInTheTime|diskAheadControl
RockerDirection|passesRelatedIntent
maxcut_attack_04|wellContext
AsyncSpriteState|doubledEveryUnlikely
maxcut_attackmode_08|m_timesHandling
MaxLineWidth|alsoAlwaysDestructors2
addSpriteFrameListCallBack|uniqueRemovedConstexpr
maxcut_attack_03|m_destroysParametethRequire
registerSetWhiteCb|exactlyDigitsStudentFlip
MAP_SPAN_X|m_compilationEasier
MAP_SPAN_Y|evaluatesInteractsWork
registerSyncChildActionCb|appliesCompletelySupport
_FlyTriggers|accessedOperand
m_ActorComponents|m_ideaInteractsExpanded
copulationNumber|preferredLanguageClause
resetSpriteAct|promotesUnchanged2
m_needLoadTextureList|amongOperatorclickMinimal
registerSetActorVisibleCd|longtypLimitedTable
inGroupCount|possibleFlagged
m_ischecking|m_fithatSequential
retainMainRole|illustratedCoupled
convertRoleMovePosToMapPos|grantsTimalthough
stand_inited|m_cerrComplicated
m_despiteAlwaysEach|keywordApplies
m_checkResType|m_destructionInitializer
maxcut_attackmode_03|m_noneCovered
m_visibleState|m_referringConstructing
ClipboardHelper|elipsisAbstractionTrying
isTouchInside|matterUnequalUnnecessary5
m_showBloodAnim|m_modelCompareisbnVariable
m_syncPosMoveDistance|m_careSelects
m_checkOpacityGap|m_friendshipCompute
BlurSampleNum|sourceInstantiatedHolds
updateTouch|ultimateExtendedLarge
m_unselect_action|bestObjectsthConstraints
m_async_pvr_path|m_thexercisesMachinesSuited
PrintPosError|cabeIntendChange
removeAddTopHeadNodeToMapCb|discussioofConvertible
m_boPhantomMove|m_aliasesCalcShaking
SocketData|tpreviousSwappedAllows
m_renderList|freesSpecialized
canShowNormal|builtSetsLibrary
IndexFromPoint|handlesDescribedDescribes
autoPathFlyTargetPos|m_separationOther
ShowPlistPath|endsFonumberExpanded
WsThreadHelper|m_operationsStrategy
scroll2Tile|promisePreferred
preAsyncLoadImg|protectionDesigners
collideInTheDir|subsetDeterminesPossibly
m_targetPosList|fixedDimensionControls
playActionData|programmersImplicit
registerAddTopHeadNodeToMapCb|henceChose
s_sendMsgBuffExEx|m_enoughAttempted
AWC_setOnRide|scopedStoppincondition5
closeSocket|cursorStoringDistinctive
m_mapScale|m_correspondingGuide
stopMapAction|emplaceGuideUnique
removeWalkCb|destructorResetGroupWorks
maxcut_weaponeff_03|ordianaryWmustEmbodies
pushLongLong|resideJumpingCaller
fly_inited|m_intvaluesenumDeclared
initDataAndFunc|currentAfterBlueprint
removeSetLocalZOrderCb|passedNumberFirst
ScreenVisible|randomMostExhasuting
addSpriteFrameListAsync|regexReleaseException
performedAnimatedScroll|derivationUsuallyInspired
magicUpToPos|exactlyImplementsMark
scrollViewDidZoom|detailedNoneCmatchRemain
onMoveSpeedChangeAction|makesImageClearForm
OpenActionCheck|braceEmplaceIstream
TouchType|doesndifferElemeis
numberOfCellsInGroup|peopleDifferentlyUnduly
m_screenVisible|m_mismatchedSkimWmust
moveMonsterByPos|withRestrictedConfusion
hurtKneelToPos|tendsInstantiations3
removeSetOpacityCb|solutionUnderReduce
changeFullShortMode|recordSalesRemainder
SkillCtrl|incrementallyReport
ODSocket|functionalityIcase
beginAutoAct|includeRolesStream
stopMonsterByPos|bitsetsInitialDetail5
WhiteCb|nonstaticDerivation
ShowHeight|peppersApplicationsTokens4
m_scriptSelectedHandler|m_curliesLength
m_currMode|m_themIntendedWrote
m_isOpacAction|m_henceBuildsCalculated
m_moverPoint|shorttypOccurConverted
scrollViewDidScroll|preventedGivesProperly
FullMode|easierUnableLooking
hasVisibleParents|compileAlphabeticCloses
removeResetDisplayCb|minimizeDespiteNodefault
SHOW_STATE|realizingCurlyNecessary
m_needSyncPosToServer|m_contentVersionClose
m_restoreFirstFrame|rightBuiltPowerful
changeStateWithChildren|errorPairwiseConvertible
m_actorType|m_entryDescriptionPush
TitleLabel|instancesAskingCreate2
m_monster_id|m_notifyNonstaticPlace
m_playActionWithChildrenCb|callsListthSucceeds
getContainer|determineSucceeding3
PlistNum|implementsDeclaredAkin4
cellSizeIdentical|interactionConceptually
NeedSyncPosToServer|documentationSafe
hideJoystick|mustActsResponses5
hasBlockAlong|triesDescribeCopy
m_OnBodyComponents|m_writtenCast
_m_stand_time|instantiatingWhich
hasBlockPos|witaTheyWriteCompared
isLoadFinished|headerSequenceRewriteOthe
beforeDraw|definitionSubstringRead
addAutoRemoveAction|includedGuaranteePreserve
loadPlistAsyncCallBack|promptDestructors
unbindPlistAsyncWithEntryId|explainsDelegatesCallpass1
onUIThreadReceiveMessage|constructingComplication
SpriteBase|programmingTrying
registerFootprintsCb|strcmpAbstractionPersist
_vCellsPositions|iteratorsAccumulate
IsResReady|operandsSuppliesCurtok
space2Screen|characterAffected
registerSpriteInitCb|persistMubeApproach
attackToPos|functiwithSupposeparate
_indexFromOffset|avoidPatternItasOught
m_weaponEffectPath|m_hardestConversionchapter
BaseAnchorPoint|pointerfifthTendsPlaced
_setIndexForCell|matrixEmbodiesSpecify4
m_isAddRenderList|m_abilityWhthe
NowActByDir|treeRequirement
showAllActionChild|thoughDiscussioofWould
relocateContainer|holdsThatStrcmp
CurrectDir|constantMemberwiseBitsets
WeaponEffectPath|charbitsTwinAppeaanywhere
ParentReorderChildDirty|twinNameRewrites
AsyncLoadPlist|bothLock
IsSystemFont|definitionsOverActually
MainRole|conflictRewritesFollow
cczPlistData|nodefaultInsert
_scrollDistance|m_reportMake
_loadingThread|m_preprocessorProcess
m_openActionCheck|m_arrarecallSupposeparate
SpriteType|redeclarePartReaders
resetPosByHead|frontUnequalDelegate
m_moveKeyPosCb|m_knewWhversion
girdCellLongTouched|identifiesProgrammer
OutLineSize|treatsFixedHandled
onBeforeDraw|operatesApproachPrevious
maxcut_weaponeff_11|m_newlineMachine
calculateOffset|succeedingDecrements
SpriteDir|sufficientlyBitwiseNocopy5
IsAddRenderList|affectsObjectsthEnable
m_showLayers|m_resetMakes
_objAttrs|nonpublicTimesItself
removePlayActionWithChildrenCb|createdIsfifthCacall
m_SocketState|aboutExecutable
HideWithChildren|becauseFeaturesLegitimate1
updateBloodAction|tpreviousTypeShould
ColorWrite|fieldEnforcesUnchanged
registerSetVisibleCb|generateSafeScoped
m_attack_mode|othersLabeledTextquery
_sleepCondition|haveDeclaring
_componentOffset|inevitablyResponses
updateNowAnt|designersOperatingGives
removeActor|akinCurrentHardest
hurt_inited_idle|m_nameAbout
m_showNameAndBloodState|m_familyBackThan
attack_inited|compareisbnActualOperands
applicationOnUpdate|cmatchDeterminesReflect
m_touch_rect|m_precedenceErrormsg
_remainTime|safelyDestroying
MapSize|storesComplexManaged
maxcut_fly03|allowedThree
loadPlistAsync|decideValuesValue
cczPkmFile|prohibitPassStudent1
BasePosition|saidExercise
pushDouble|inlinedQualifyRtti
PetOnRide|fallSafeAppear
walkInTheDir|castVaryingHides
AsyncDownloadManager|indicesGrouped
m_syncReplace|denotingPostfix
m_isLoadPlisting|m_dereferencesSupposeparate
ModeState|allocateIndependentEasy
SelectAction|deallocatingWritingScope
registerRockerCb|pointsunlikeAppropriate1
ProtocolPacker|assigningLinkingKnows
doStreakToTheDir|allowedReasonPassed
flyTmpHandler|declarationWorryGranting
md5_starts|leastMissingSetting
m_isLoadFinished|certainAvoidAgree
m_center_node|m_attemptsAsking
numberOfCellsInGirdView|evaluatedKnowFeatures
YScrollView|twinPreventRemember
downloadFinish|iteratesExhasutingExpand
role_main_id|m_grantsPush
SpriteNpc|schemaDeclaring
m_rocker_dir|m_messageLeave
VisibleScreen|directionAlreadyOptions
m_roledata|resultingRepresents
autoMoveShow|lifetimeTextquerySupplied4
tile2Screen|packMoreAround
rocker_loop|mubeWriting
Effects|preserveDifferences
m_bitsetheInitializeby|saysSubstringLarger
m_reset_display_cb|m_identicalSaysBegin
SpriteMonster|parenthesesPrimer
SeedRandMap|holdsFindsCalls4
SideTilePos|preferMustDynamically
_cellsFreed|m_unrelatedEcmascript
FlagValue|authorsMatchingCorrect
registerUpdateTopHeadPosCb|triggerImplementation
AWC_setActionStateChange|beginRestrictionsAssumes
registerTouchDownHandler|otherwiseVariaband
base_url_backUp|findsListsWstring
MainRoledata|affectKeywordBits
createWithSymbol|optionsStringsUndefined
AttackNum|treeMeaningSwapped
m_scriptUnselectedHandler|m_denotesBookno
AsyncFileOp|multipleNullCopying
createChain|charactershavingOperates
deaccelerateScrolling|replacementPermitted
m_sprite_init|safeArgs
m_speedPercent|previousIntent
m_setPositionCb|m_booknoAlegal
CenterItem|letterWefifthRtti
m_touchEnabled|m_theifUpdateFollowed
successCallback|m_functionalityContains
m_isFinished|hashEspecially
cleanPathByFly|copyIndependentFriends
m_repTypeId|moreovesomeStoring
m_blood_back|complexityLegitimate
registerTouchUpHandler|constsInherentlyIath
createDownloadDir|comesPrefiThrowsSynonym
m_isLoadTexture|cannotTimesConstructing
ComponentByTypeAndId|bodyCountPrvoid
HandlerType|distinctWefifthChosen
needAction|m_initializedUnnamed
_moveCellOutOfSight|whversionPointersSimplify
OCC_FLAG|bitsetsAssociative
FootprintsGap|soonErrorsStatements
m_sendMsgCount|m_alwaysConnection
StandTime|althoughSpecified
maxcut_run|chainSpecializations
_needRelocateContainer|thingsLegitimate
addSpriteFramePlistCallBack|functiopresentedOutput
OperateLayer|authorSynthesizes
InitMsgBuff|destructorIdentifying
scrollViewDidStopped|curlyInitializationsView
m_phantomMoveFrame|m_authorAllocateTypeinfo
m_delaytime|m_careDeduce
initWithDataSource|consultRecompiling
MainSprite|thenEssentialDeclared
initDependTexturePathList|whifCollectionsIsbns
_direction|expandPrint
AttackModeWithChildren|convertsGrammarExtend
cleanAstarPath|convertedFollow
m_userOldMovePos|m_circumstancesStatics
walk_inited|knownDealStay
isTouchEnabled|studentEscapeConversion
removeActionChildByTag|existingCurlySpecialized
MapOperate|accumulateThreed
MonsterId|illegalOlderFixed
checkSuddenDistance|integralPrecededAssumed
UnToAttack|successfulRecursiveTrying
stoppedAnimatedScroll|moreovesomeCalculateAlong
AsyncDownloadState|studentNonreference
MapBackLayer|togetherStandard
_responseQueue|m_occursCallable
m_cellImageSuffix|m_regardlessExpression
YGirdViewCell|resideComplexitiesNumeric
PlistPath2|changedSections
AsyncDownload|genericHasptrHowevewe
m_currActionState|chparameterPredicted
VisibleRole|typicallyTransactions
m_touch_enable|m_stoprocessingThroughout
stopMoveAction|parameterDeclaring
onSuddenFinish|compilePatternNaturally
GenerateMD5|pointsunlikeOarguments
removeSetVisibleCb|worryClosesComplexMachine
addSendMsgCount|destroyingPartially
removeAllHandlers|scopedEnumerations
_beforeDrawCommand|m_unnecessaryFlip
space2Tile|promotesRequireEnding
DataSource|literalsDeclaringCover
updatePosition|gradesInvolveOperations
loadSpritesPre|matterAllowSynthesizes
DefaultActionPlistPath|meaningOutsideContaining
autoMoveShow_ex|memoryExistsSynthesizes
checkCanWalkabledTile|newlineNonvariadic
update_pecent|initializtheCopiedWhether
LuaEvent|automaticDefinitionChosen
ActionEnable|articlesAffectsPrecede4
m_select_action|supplyLargelyThposition
syncPosToServer|tokensThfunction
setContentOffsetInDuration|deducedReadsWord
initMapData|visibleFindsCleansKids
_scissorRestored|revisedCare
updateMove|averageCodeSimilar
WeaponEffectPosOffset|intuitiveFlipsImmediately
maxcut_ride_stand|m_kindsLearnCompiler
m_setActorVisibleCd|m_knownLongtypSmaller
main_sprite|deduceChapter
removeGotoDeathCb|escapeSeenRuntime
registerSetPositionCb|objecChoiceOperands
ride_inited|m_evaluatingCauseRationale
ResetDisplayGap|sequentialAvailable
m_mapTextureList|m_insideParentheses
SpritePlayer|determineCurrently
ActorRenderType|scopeCapital
m_blockStr|m_althoughRegexBefore
textureKey|m_revisedRequirements
removeHandler|incrementingAbstractly
__indexFromOffset|efficiencyNewline
createBaseWithCache|elementUpdatesLinkage5
m_onloadPlay|m_matchLockMultiplying
flyInitPos|m_leadsReads
m_numsCache|m_actionWcannot
moveMapByPos|onlyClearConstitutes
m_addTopHeadNodeToMapCb|carsCompatible
AWC_attackMode|meaningEvaluatesFreesBeen
m_isLoadTexturing|m_optionsWhifEcmascript
DefaultMapView|morePlacedWhen
ActionHide|parenthesesWithNeed
sendPointsByPath|initiallyOperandsLast
IndexFromGroupAndInGroup|forgetSuchBehaves
cleanAsync|availableCompilation
run_inited|dimensionRecently
SpeedFloatPercent|normallyWantsThoutermost4
AWC_changeActionState|mainTreatedOwhich
m_actionOpac|m_toldThoutermostAppears
gotoRevive|transformationThree
UnSelectAction|readingThfunction3
_isUsedCellsDirty|trivialOutputUnder
checkPlayDefaultAction|bothStoppinconditionWish4
removeSyncChildActionCb|knowNumericRelational
LuaEventManager|mutuallyAlreadyIntuitive
m_syncActionCb|m_illegalVerifiesNeeds
MainNode|assumingDefinesSubmatch
m_suddenDistance|incrementingCalculates
onSubThreadEnded|betterBlueprint
md5_context|hiddenArraysHide
YGirdView|indicateStrcmp
SpriteBlur|reasonMessageStudent
_entrySeed|m_includeArrayExpect
registerWalkCb|operatesOptionalIndeed
m_baseOffset|m_replacedStops
m_actionOpac_c|highReliesExplaining
addRenderListCallBack|allocatedDestructorTarget
ThreadSendMsg|usableDescribeTesting
removeColorGray|describingConsultWays5
_updateContentSize|reduceMakeWorthRevised5
sub_pecent|m_interactionCare
resetDisplay|arrarecallIndicatingOften
m_instance|m_areaNonconstHidden
cczPlistFileDir|techniquesNamingMark
ActorActionManageC|ostringstreamLogical
move_speed|m_returnedWhifAdding
start_tile|m_instantiateLeastErrormsg
readThread|largelyFragmentHandles
FlyModeValue|equalityFamiliarCover
m_stepTime|m_pointsDepends
checkMainRoleTile|illustrateStopRemain
fixMapPosOffset|surprisingExpectsSays
m_smalltobig|m_synthesizesLifetime
m_beginPoint|runtimeApplies
m_base_cache|jumpingBasic
updateCellAtIndex|substringListitemNotify3
_touchMoved|m_curlyVaries
m_needLoadTexturePathList|m_overrideImplementing
initMagicStatus|divideErrorsReach
CMD5|thatheyRequireConsult
FlyModeWithChildren|allowsKidsExhausted
removeCellAtIndex|determinesTakesStringth
onSubThreadLoop|executeLoopWcould
AWC_stopInTheTime|inheritanceEffectively
JustDelayCheck|publiclyCalculateWords
resetSpeed|goodTemplatesValuesState
initRunStatus|programmersSearchBuilds
m_plist_num|defaultsResourcesAllow
restoreMainRole|wilreferThanConstitutes
MsgBody|createFixedAnswer
checkFlyPath|evaluateGenerate
BaseUrl|runningPdataExists5
m_asyncEntryIdList|m_tryingNonconstIdentifying
SmallToBigMode|partsExistsImmediately
ColorGray|computingSplitRequested
BloodVisible|pointerwhenMajorProgram
m_center_pos|m_streamEvaluates
CurrActionState|purposesReliesPromise
m_sDirectoryName|m_exceptionAliasHelpful
SkillPhantomMoveEffect|originalGeneric
checkVisible|ableAnotherDoesAccess3
LUA_YGirdViewDataSource|knewIntroductory
UserOldMoveMap|knownFithatWithfifth
changeRePlayTypeAndResId|pastExpandedShow
MainRoleId|untilOrdinaryTimeGranting3
MapSendByte|fifthRequirementsWregex1
loadMapStr|initializerImaginePath
m_FatherType|separationOrdianaryJust
_plsitInfo|m_roomActuasize
initAttackStatus|directionErrorTreeStore
_callBackList|m_soonTreat
YGirdViewDelegate|bracketsChartyp
registerGotoDeathCb|throwsBrieflyAssignReused
m_blood_bg|m_varyCondition
m_zOrderFlag|m_gradingInitializeby
m_needReleaseFrameList|operationInheritance
tile2Space|cursorRttiExtent
m_spriteInitCb|m_precedeExpression
updateAllAddMapId|delegateDealBuilt
ConnectIpv6|understandingMachines
playStandEffect|nestPerformNonpointer
m_defaultFileName|m_instantiationsWithout
_touchLength|m_striparameterSpecifies
addMoveTarget|stringthCalled
m_versionChannel|minimalItemSale
initWeaponEffFrames|compatibilityPositioned
onSubThreadStarted|attemptTargetSize
checkMapCellIsDownloaded|positionedImportance
TimeLabel|limitationConstructor
DirByDirection|developedComputational
SingleVisible|ensuresCharbitsPrice
waitCloseReadThread|authorsProcessesStart
MapRecvByte|advantageDoethBeganBase
addHandler|containingGoodUpdate
m_showState|choseDeclaration
EncodeBuffer|loopSpecializesAppears
m_blood_pro|m_otherSomewhat
ComponentAttrsByTypeAndId|sometimesAuxiliaryVary
checkCanWalkabled|familyMimicDelegates1
startRocker|delegateEndingRepeatedly
CurrentActionState|presentedWmustRefers
AsyncSprite|fetchGrantingCompilers
MenuButton|hereListitemNonpointer
fixAnimDir|preventsAddedAppear
HostValue2Big|dependsViewDeallocating3
maxcut_attack|m_variesCalculates
callBackAction|opposedDetermineEnough
isDownloadingOrJob|goesVersionExpanding
m_renderListEntryId|m_fifthWarrant
m_suddenCheckGap|m_pointerfifthExchange
addCacheSprites|caltoSubstringConverted
maxcut_hurt_idle|totalSeparatedUnder
insertCellAtIndex|computationalExamines
isTouchMoved|interestingStudentEasier
addCallBack|goesDeallocatingThcall
m_load_all|endingWordsWhyou
VersionChannel|goodTheareEverything
getViewRect|onbitsBlueprintAverage
LuaSocketState|bitwiseComponents
IsFixAnimDir|supplyEndingFaced
m_cache_anim_List|printingBetter
copyMainRole|easiestEscapePrinted
LoadALL|certainOstringstream
ResLoadStatus|compatibilityAllowed
VisibleState|afterInitializerIand
CplusShowMsgID|choiceWhatCast
applicationOnExit|striparameterHelp
m_is_system_font|functiocontrolExitValid
removeRockerCb|arrowSoonThen
ManagerByState|algorithmArgumepassedArea
TouchEnable|assumesForgetDimension
maxcut_attackmode_10|expressionasSucceeding
maxcut_attackmode_11|m_nontemplateRunsNonextern
maxcut_attackmode_12|m_successfulThgenerates
removeSetActorVisibleCd|coverHandlingInvolve
SendBufLen|closesDifferenceFails
m_syncPosGap|m_runtimeTimeGiven
m_setVisibleCb|oargumentsAdvantages
OffsetPos|meddleImplicitWanted
AWC_playActionWithChildren|addingInterchangeably
m_stand_times|m_specializingShorttyp
girdCellTouched|existUpdateInvolve
m_TopComponents|m_representationPrinting
LuaSocket|currentlyCreated
NameAndBloodShow|onbitsProperDeleted
moveMapByPath|causeThoughCompiler
m_curTargetPos_tile|m_imageOmitting
m_footprintsMoveDistance|rankedUnnecessaryRemain
m_actionStateChange|m_assignmenclickAbstraction
_DisplayNode|tellsMovement
m_move_direction|m_indexingSimilarlyEnforces
m_footprinsOpen|arrarecallOccur
m_suddenCheckGapMax|entryBasicWita
IsOpacAction|delegatesEnsuresFail
AsyncCallBackInfo|reverseCreated
ZOrderFlag|imagethWithOverride
removeUpdateTopHeadPosCb|totalValuelikeDecrements
_requestMutex|curliesBoundthatPrvoid
syncNameAndBloodShow|limitationChosenReport
screen2Space|approachActuallyDenoting2
removeSpriteInitCb|knowLongerPrevent3
m_swallowTouch|greaterOarguments
m_resReady|m_handledIsbnDetail
addCacheSpritesPre|alphanumericSupplying
m_isAutoMove|listsWorth
ViewSize|unscopedWidthIdentifying3
DefaultMapBackLayer|m_obviousEquivalent
NearTiled|ideasNotedCompiler
Direction|changedOarguments
LuaMsgBuffer|instantiationThumbJust
changeMode|generatedDescribing
MapScale|recognizingSemicolonOffer
_responseMutex|m_establishesSuch
ProtoBody|latestPrintedImplement3
excavateToTheDir|blobptrVariousNotify
m_actionHide|testingRelying
addRenderListCallback|operateIndicatedScope
m_thread_quit|differentlyObtain
hurt_kneel_inited|m_preferWmust
cleanOtherActor|entireDebugging
removeSetVisibleScreenCb|divideDetailedWant
Commen_Direction|specializingThenTempting
ActorType|assumesInstantiations
AsyncStruct|m_onceDenotes
FollowNode|castApplicationNaturally
CenterNode|periodVersionsLonger
Touch9Sprite|turnsRestIdeas
moveInTheDir|flowsContainerDelegate
m_rocker_direction|m_shakingDivideSeparation
m_restTime|m_subsequentFindsBinding
NameSize|valueFormSmatch
m_managerInitNum|m_affectOwhichSuspended
_cellsUsed|flowsTakeDefinitions
loadFlyTrigger|storingEncapsulates
m_components|explainsComparedPointer
initDeathStatus|encapsulationLoops
setViewRect|differentlyGuaranteeSlow
maxcut_stand|correctNatureBitset
onAfterDraw|conceptuallyDestructors2
DownloadUrl|showsReadingChartyp
IsConveyAction|behindIncreasedArguments
SpeedRate|callableBrieflyDiffering
m_isLoadPlist|downTheif
m_setWhiteCb|m_colorStateParametea
pszFileName|m_followsOmit
PathByPos|becauseTextNumbers
initFlyStatus|aboveCurliesOverheadCerr
_AppMsgFlagTo|obviousAskedIntegral
cczPlistFileWork|intvaluesenumSimilar
GroupAndInGroupFromIndex|algorithmsStopsReal
isDragging|queryNonvariadicRecently
m_beginNode|m_naturallyReferencesProper
syncSendStateWithChildren|trivialDatsuchOmit
playAction_ex|oughtRemainingFurther
m_loadTextureEntryId|m_concludesInstantiations
m_actionOpacGap|m_preventsMoveRecursion
m_unAttack|m_differentlyInitialization
targetPoint|m_functionfunctionOthe
reloadData|transThosmembersClose
maxcut_ride_run|referenceCounts
m_farLength|m_subsequentRightSource
DisplayMap|particularSeparatedBuilt
addTextureSprite1|behavesGeneratingUsers
maxcut_death|guideDefininside
BlurRadius|havingConvertedThings
_blurSampleNum|constructorsLearned
m_sleepCondition|m_advantageJumpingPreceded
ActionWithChildrenType|supplyDebugging
m_map_allAdd|m_wordDatabaseStorage
addPhantomMoveEffect|pointersDetermines
initHurtKneelStatus|exercisesCharactershaving
suddenToThePos|basedVariousPeriod1
_successCallback|entryRatherUnlikely
m_time_label|enumerationsEncounters
m_rotateDrct|m_thcallInformForgot
LeftTime|namedSeesSeriousReflect
m_justDelayCheck|abstractPast
rocker_loop_max|m_relationshipAlthough
registerDownloadSucCb|neitherAlphanumericBehind2
errorCallback|m_pscreenCalc
m_touchType|m_operatingHasptrTypically
m_auto_clean|m_suppliedInttypes
_deltaTimeTmp|m_flagsTakesEnclose
initRideStatus|althoughSpeakSeparation
_selfAdaption|m_ableRedeclares
_container|elemDifferencesAggregate
MsgBodyLen|treatedNearlyExact
_AstarNode|secondVerifyUseful
ActorFlag|whereVariableEnumerations
death_inited|invalidAlegal
AWC_flyState|thingInclude
m_allShowWithoutCheck|m_presumablyReduce
PlistsNum|flaggedTemporaryBitvec
maxcut_weaponeff_10|ensuresManaged
FlyMode|candidateOptionsBegun
m_offsetPos|m_wishPrinted
maxcut_fly01|m_charbitsWrong
maxcut_fly02|m_compatibilityExclusive
m_curTargetPos|describesBlueprintDepends
m_resSuffix|m_seenConfidentAverage
registerSetOpacityCb|ecmascriptThan
registerSuddenCb|possibleAbleLargely
SpriteGuard|workRedefines
FontChina|aboutInitializersSolution
EntryId|freeTheirWorries1
print_storage|runtimeRightVariable
updateJoystick|tableAlmostPass
AsyncJob|conflictSimilarOccur
m_footprintsGap|m_operandsLoopsChapters
resetDisplayGap|m_expandMinimalInitializers
_asyncStructQueue|transformationDecrements
_addCellIfNecessary|addsChainQuestion
cczPkmData|underIsbnTestStored
playerAttackToPos|behavesAppliedOlder
stopRocker|earlierColor
PositionFromIndex|explicitlyMightSelect
syncKeyPosToDetailMap|coupledImplementsRange
ActionStateChange|compoundAuxiliaryEntry
hideAllActionChild|surelySharedThroughout
groupCount|westoreClassclickSuited
ShowTag|errorsNocopyDerived4
LuaEventExEx|temporaryExistInto
Commen_ActionToDo|constraintsAssume
sendPointsByAstarPath|centralBodiesMimic
initWithFileExt|spellingReferencesthTree
ActorRenderQueueManage|startWhatever
m_pszFileName|m_underlyingVersions
_progressCallback|expressionsClasses
popLongLong|redeclareBoundthatEntry
checkMapIdInAllAdd|implementIndependent
s_sendMsgBuffEx|m_suppliedWorries
OnRideId|stunninglyPrevents3
flyTriggerList|separateRecognizing
initCheckFlg|inherentlyPointed
Tools|transAdditional
removeComponent|witaSoonExtent4
m_isActive|m_basisFlowsBriefly
YGirdViewDataSource|wishFamiliar
registerSuddenDistance|heightAvailableCorrect
CacheNum|iostreamAggregate
YScrollViewDelegate|nonexistentRuns
_blurRadius|promotesSolveTakes
MapView|surprisingRedeclare
ActorId|againEffectively
flyToTheDir|meaningDeducesClassclick
calculateAssetPath|createPassingEncapsulated
m_fly_mode|changedPeople
_parentScissorRect|m_threedBuilds
girdCellWillRecycle|mismatchedNotedPrefi
HandlerMap|m_muchContrpassesExamines
initAttackModeStatus|usersGreaterTypically
m_loadPlistEntryId|namingConstitute
removeSetPositionCb|existsSpecifyWide
DecodeBuffer|indicatesScopingModern
MakeNumbers|reusedInformation
pushDataByString|explainInsteadShows
attackOneTime|anglePathSafe
dir_next_tile|timalthoughListed
NameLabel|returningPrinted2
updateShowState|causeFlagPubliclyOught
SendMsgCount|chartypStopsNature
actiontime|m_withCompare
VisibleCustom|queryReversesReferences
m_show_plist_path|m_getsEquality
ShowTexturePath|countsMoveYields
ConveyState|successfulManagerTreat
LUA_YGirdViewDelegate|appliesTesting
girdCellAtIndex|stoprocessingSolveKnows
m_suddenTargetPos|m_movementActuasize
FootprintsOpen|numberIntendingSurprising
createToTheDir|readPresumablyPredict
TileByDir|angleChangedTypedefs
moveMapByTouch|particularExhasutingReset
CenterPoint|witaTurnAccessed
AttackMode|doubleprecWithfifth
FatherType|discussioofThatheyCentral
m_name_label|m_thusSpaceSimply
IsFinished|undefinedparameters2
_m_touch_time|m_stackSimple
registerMoveKeyPosCb|beginningTpreviousLevel
systemMoveRoleToPos|resultSharedWere
MapSpan|neededParametersSubscript
ShenbingStatus|comparingStackStrategy
addTextureSprite|allowedReimplementAdded
removeSuddenDistance|doneFunctionalPlaced
digToTheDir|alternatively
initStandStatus|iteratorLinkingAccording
ShortMode|ecmascriptLimitAsfifth
DirByTile|countsRevisitedAgain
ActionState|behalfRequirements
checkMovePos|resolutionStrcmpLiteral
DirectionByDir|incrementallyReplaces4
StFPSlog|convertedDelegates
OpacityCustom|simpleDefiningIgnored
m_showNums|algorithmsFunctions
repSpritUrl|movesAppropriateSupplies
DisplayStatus|parametersReallocates1
m_noMove_cb|m_stoppinconditionMatter
OnRideWithChildren|specializeConceptually
m_setOpacityCb|m_controlsCompileWithout
m_customlistener|m_nonexternExplaining
initAttackRushStatus|relativeTedious
updateOpacityAction|settingAdvancedBother
m_showMsgID|m_supportedDigits
m_speedRate|m_implicitHandleAssign
ShowLayer|arrarecallRequestedFinds
cczPlistFile|parametersEasyCommonly
maxcut_attackmode_09|m_tryingChparameter
_cellSizeIdentical|m_thusWhole
maxcut_attackmode_07|m_heldExternfifth
maxcut_attackmode_06|m_understandWithfifth
maxcut_attackmode_05|m_indicesDefinitionsDefined
maxcut_attackmode_04|m_variableCaller
DirIDByDir|actionUnrelatedLooth
maxcut_attackmode_02|m_everyDealingTypes
maxcut_attackmode_01|selectedWherebyAlways
TouchSprite|encloseFive
m_center_item|m_olderAllocateWorry
BloodType|happenDecideEquivalent
calculationArrival|flaggedTestingApplication
CLuaParam|isbnsAssigning
m_downloadListenerList|m_treatedGuaranteePredict
runLuaFunc|beforeExceptionsSucceeds
m_plist_loadnum|m_wherebyFunctiocontrol
removeMoveKeyPosCb|scopeCopyingNote
s_sendMsgBuff|m_anotherBindingSelected
showNameAndBlood|lockSurprisingSupplying
m_petOnRide|m_managedSome
m_viewRect|nodtorBuild
m_nameSize|triesStudyChange
SuddenSpeed|alsoScreenEncapsulation
s_recvMsgBuff|sharedNothing
MaxReadCount|largelyResultingMutually
hurt_inited|surelyViolationsNumbered
DirByNowPoint|nonpointerFacedLegal5
m_OutsideBodyComponents|m_personIndicatingInstances
m_sudden_cb|m_tendAppearPassing
_requestQueue|m_remainingRegexHierarchy
BigValue2Host|fiveAgainDiscussion
addComponent|wrongRealizeDecide
m_suddenDistanceMin|validFourRedeclare
m_managerList|m_parametisOperateRelative
progressCallback|distinctiveSwapped
AttackModeC|checksVaryGeneral
doOpacityAction|subscriptClassesTokens
m_auto_clean_cache|convertedProperly
insertActionChild|bodyExtendedThese
m_setLocalZOrderCb|m_instantionAbstractionSale
girdCellHighlight|considerApproachKnown
m_random_mode|m_functionChartyp
maxcut_hurt|separatedSensible
sendSocket|allocatesWouldCharacters
_errorCallback|legalDesignsCmatch
md5_finish|onbitsWcouldEqually
magic_inited|m_swapLarge
m_shenbingStatus|numericActuallyCentral
convertMapPos2EdagePos|definesComesRunning
md5_update|promptCompiled
m_componentsAttrs|m_simpleAbstraction
AppMsgHead|computeOtherConsts
m_start_point|m_confusionCursor
isactor_flag|m_closesLimits
playActionWithChildren|addsOperationWhereby
m_isFixAnimDir|m_employeeEcmascript
auto_download|m_destructionThgenerates
maxcut_magic|m_existsArrowElemeis
m_isAstar2Finished|m_memberDirect
m_suddenSpeed|m_allowAkin
m_show_texture_path|m_calcDeleterConswhat
PageIndex|notedRememberStrcmp
registerTouchMoveCb|freedBetweenCreate
removeSetWhiteCb|statePossibleExecuted3
m_conveyState|m_commonlyPrimary
addTopHeadNodeToMap|flipsDesignedFonumber
m_is_right|answerUnchanged
m_setWhiteComponents|triggerAffectRequires
LuaBuffer|stringstheTransfers
girdCellUnhighlight|onalthoughPreserveAttempt
m_updateTopHeadPosCb|m_updatesOverload
m_onRide_id|m_needElem
m_followNode|m_greatlyArgumentsExplain
shadow_sprite|m_convertibleAssigning
asyncEntryIdCallBack|informationColonListth
m_touch_move_cb|m_secondResponses
m_isInRenderList|m_operatorclickRandom
ConnectNormal|macroInitializationCurly
_m_move_time|m_deallocatingFetch
registerResetDisplayCb|swappedConventionStay
openSocket|nonpublicEcmascriptAlias
ShowBloodAnim|opposedTriesArraythe
m_pszFileNameList|m_ostreamDenotes
_cellsInGroup|m_slowDeduction
_objRender|minimizePurposesAverage
BtnContainer|hereEffectivelyLike
PageByIndex|abstractionWithinLine5
findTriggerByPoint|themselvesCerrDoubled
m_gotoDeathCd|m_createdRejectRemaining
m_checkOpacityMoveDistance|m_submatchUsesEnsure
_indexFromOffsetInGroup|calcFromProgrammer
syncFlyStateWithChildren|rvalueDiskEamight
_asyncRefCount|m_partnoLanguage
_updateCellPositions|redefinesDetailBehavior
playAction|importanceInitially
removeTouchMoveCb|thgeneratesLookupUnduly
updateZOrder|succeedsPropertiesForward
cleanDenpendFrames|facilityDifferencesSample
maxcut_hurt_kneel|beenIgnoredGreatly
maxcut_weaponeff_12|wilreferRelies
hurtIdleToPos|topicsRankedTopic
AutoInfo|guaranteeSynthesizedChose
registerNoMoveCb|knowledgeOlderRegex
AWC_flyMode|havingLabeled
m_actiontime|differsIntent
LabelChild|basicsDesignsFoundHeld
initHurtStatus|facedContentsBegins
initHurtIdleStatus|resourcesExonlyBracket
initGLProgram|deductionFunctionalthough
_touchPoint|m_focusFreedCalculated
addWeaponEffect|impactExplicitlyAcross
stopMainSpriteAction|exitRedeclaresWhich2
registerFlyCb|shorttypSupplyingHide
createEffect|protectionCardViable
m_isBloodVisible|placeAutomatic
MsgID|bitsetheShaking
m_boSkillEffect|flipThosmembers
AsyncPvrPath|notePrvoidComparesScoping
AWC_conveyState|bitsetsSmallerConstruct
m_actionOpa_state|somewhatReason
LabelNodeC|hereGrantingThough
OutLineColor|encapsulatedExplains
m_title_label|m_recentSpaceReduce
removeFootprintsCb|checkContaianyChosen
roleMoveOnMapByPos|debugdeleteResetPrior
MoveDirectionUpdate|fallBookstoreThese
IsRepMode|coutLegitimateSafelyFour
is_getData|m_ulongAnalogously
unbindPlistAsync|factorialSupplyLink
MOVE_CHECK_GAP|m_relevantListitemRevised
girdCellSizeForIndex|mutuallyWhetherOstream
initWithViewSize|preciseGradesSensible
scroll2Pos|inherentlyActionsDirect
LuaEventEx|reviseFindsIdentify
registerSetVisibleScreenCb|instantiatingDetermines
RestoreFirstFrame|efficiencyTries
addColorGray|handleInevitablyOtherwise
GraySprite|differingOverhead
screen2Tile|curliesOtheInitializeby
DirByNewPoint|assigningScreenDifficult
PlistPath|loothConstantSimpler
m_footprintsCb|allowsSucceedsNonpublic
ThreadLogFunc|tildeListedFunctiocontrol3
viewSizeSelfAdaption|enumeratorCompilingSome
m_downsuc_cb|m_tableThingsNumber
_plistInfoMutex|m_hasptrRulesHelp
