strbuf_t|JIgDefininsideFunctiocontrolMG
checkFlyAutoPathTarget|settingFonumberCalculate
attack_rush_inited|m_outer_Ending
addMapSprites|soonChangeIostream
SpriteBase|JIgFlipMutuallyLayer
ActionName|stoplightCommonFileWcould
showJoystick|thosmembersTells
ActionTag|JIgRvalueAdvancedDeal
_afterDrawCommand|average_Completes
ByteBuffer|JIgDefinedWhetherHandle
m_setVisibleScreenCb|validReplaced
triggerPoint|m_distinctImportance
maxcut_weaponeff_02|m_nodtorUses
onRoleMoveFinish|inheritanceBegunPrints
maxcut_weaponeff_01|correct_Derivation
maxcut_weaponeff_06|independently_Thumb5
maxcut_weaponeff_07|m_turnsAppears
maxcut_weaponeff_04|m_majorEither
maxcut_weaponeff_05|m_isbnGrants
IsLoadFinished|witaTypcanAllows
maxcut_weaponeff_08|differingOverloaded
maxcut_weaponeff_09|m_image_Initialization
registerPlayActionWithChildrenCb|cacallIteratorNonexistent
m_autoTime|m_representation_Execution5
md5_process|targetAuxiliaryInstances
changeState|evaluateReturnedNumbered
removeRenderCallBack|wrongDiscussioofDisk
TouchEnabled|wantedInformRoom
registerSetLocalZOrderCb|informationBitsethePeople
stopInTheTime|consistsBehaviorPrvoid
RockerDirection|chartypWorksObtain
maxcut_attack_04|m_containingIncreased
AsyncSpriteState|JIgReadersCoverageManager
_cellSizeIdentical|m_textComputing1
MaxLineWidth|forwardingFacility
addSpriteFrameListCallBack|datsuchFriendshipfifth
maxcut_attack_03|denotesDescribe3
registerSetWhiteCb|gaveSurprisingly
MAP_SPAN_X|sampleException1
MAP_SPAN_Y|m_supply_Collection
registerSyncChildActionCb|randomStopsDiscussion
_FlyTriggers|JIgKidsFullSprite
m_ActorComponents|curtokAble
copulationNumber|equalsPromiseFactorial
resetSpriteAct|constructorsFetchHolds
m_needLoadTextureList|m_authorSignals
registerSetActorVisibleCd|recompileRelyingCease5
inGroupCount|seeminglyUpdatesColor
m_ischecking|m_roomAbstractly
retainMainRole|updateMainDespite
convertRoleMovePosToMapPos|abstractionExonlyCompares
stand_inited|invokesThem
m_checkResType|responsesManager
maxcut_attackmode_03|happenSomething
m_visibleState|m_specificationHighest
ClipboardHelper|JIgTuplesParenthesesView
isTouchInside|specialAssignedImplicit
m_showBloodAnim|m_ostreamKeyword
m_syncPosMoveDistance|m_array_Period
m_checkOpacityGap|m_frameworkVariables
BlurSampleNum|referencesthSeparately
updateTouch|somethingConsistsHolds
m_unselect_action|m_increased_Operands
SpeedFloatPercent|findsNeedFrees
TitleLabel|levelScopingEquality
checkSuddenDistance|searchFourTends
m_boPhantomMove|m_emplace_Library
SocketData|JIgBlobOperatorclickLayer
m_renderList|m_introductory_Separator
canShowNormal|triesMembersTransfers
IndexFromPoint|furtherContadeclarations
autoPathFlyTargetPos|m_conswhatCompilers3
BaseAnchorPoint|thoughtComponentsDuring
WsThreadHelper|m_regex_Enumerator
m_zOrderFlag|m_supportedFaced
preAsyncLoadImg|applicationsPersonExpect
collideInTheDir|decideDefine
m_targetPosList|m_focus_Whether
playActionData|rttiInttypesIncreased
registerAddTopHeadNodeToMapCb|latestVersionDifficult
s_sendMsgBuffExEx|m_increasedBase4
AWC_setOnRide|expandsTellRuntime
closeSocket|endingCompareExclusive
m_mapScale|m_throws_Behind
stopMapAction|accumulateWould
removeWalkCb|permittedLinkDestruction
maxcut_weaponeff_03|m_managedTold
pushLongLong|necessaryOperations
fly_inited|m_instantiatedContents1
initDataAndFunc|referredProvidedBased4
removeSetLocalZOrderCb|assignsOwnsEssentially
ScreenVisible|aboutShowEnclosed
addSpriteFrameListAsync|deducesRelevantReaders
_indexFromOffset|overloadedAverageBack
performedAnimatedScroll|instantiationPeriodOnce
magicUpToPos|dynamicallyOstreamConsult
scrollViewDidZoom|helpfulCannotRuntime
onMoveSpeedChangeAction|adaptorsTpassFuntion
OpenActionCheck|changesSubstringReside
NowActByDir|integralInclude
m_screenVisible|braceExpression
moveMonsterByPos|justImportantOften
hurtKneelToPos|rememberCompletelyEnums5
removeSetOpacityCb|lineFunctionAkin
SkillCtrl|JIgInitializersWhenHelper
ODSocket|JIgDuringTimesCtr
beginAutoAct|startingFollowingTurn
stopMonsterByPos|avoidDeletesPrinting
WhiteCb|regexDrivenOccurs
ShowHeight|synthesizesPreceding
m_scriptSelectedHandler|m_takesBrackets
m_currMode|m_precedenceHard
m_isOpacAction|would_References5
m_moverPoint|m_replacesInfrequently
scrollViewDidScroll|extentWholeConsider
FullMode|schemaFindsDynamically
hasVisibleParents|alreadyPreciseSays
removeResetDisplayCb|ignoreAndqueryContents
SHOW_STATE|JIgPeppersConstsCtr
m_needSyncPosToServer|resolutionComplexities
m_restoreFirstFrame|m_membersMarker
changeStateWithChildren|sizeWhversionFirst
m_actorType|m_returnsEntry
m_playActionWithChildrenCb|m_accustomed_Copied
getContainer|madeBlockProtection
PlistNum|followsSaveLookupAspects
magic_inited|m_sections_Assign
NeedSyncPosToServer|opposedUnableVersions
hideJoystick|factorialLoothAllocate
hasBlockAlong|throughoutGreatlyFairly
m_OnBodyComponents|m_containerNature
_m_stand_time|specialized_Optional
hasBlockPos|indexManualPassed
isLoadFinished|defininsideAssuming
beforeDraw|detailsExternfifth
addAutoRemoveAction|ignoredLoopLogical
loadPlistAsyncCallBack|managerPutsAssigned
unbindPlistAsyncWithEntryId|suchExplicitlyLegal
onUIThreadReceiveMessage|suspendedImplement
reloadData|wordsObjecReadsFree
m_isAstar1Finished|m_stringsthe_Reverses
registerFootprintsCb|natureInstances
_vCellsPositions|m_occursUnrelated
IsResReady|whatBefriendViolations
space2Screen|patternsDescribes
registerSpriteInitCb|objectLinkingLooks
attackToPos|whichHoweveweWhose
ProtocolPacker|JIgCurtok_HeaderModel
loadMapStr|markerReversePath
m_weaponEffectPath|machineCallable
ShowPlistPath|containingPatternInsert
_setIndexForCell|consistentHashInttyp4
m_isAddRenderList|reset_Algorithms4
TouchEnable|ordianaryConstantVaries
showAllActionChild|failNontypeExplaining
removeSetVisibleCb|workNeedWanted1
CurrectDir|firstDebugdeleteDeleter
WeaponEffectPath|initializingDone
ParentReorderChildDirty|destroyThosmembersExtend
AsyncLoadPlist|JIgFriendsReturnedTool
IsSystemFont|everythingDimension
MainRole|classclickOperandSure
_scrollDistance|m_failStops
m_openActionCheck|m_reviseMembers
SpriteType|JIgThfunctionResolutionBaser
resetPosByHead|accumulatePointsDespite
m_moveKeyPosCb|m_introducedRequired
girdCellLongTouched|onlyOstreamIostream
OutLineSize|forcesCeaseSafe
onBeforeDraw|surprisinglyNotedAbove
pushDouble|happensRequirementsSecond
calculateOffset|accessedInaccessibleCalc5
SpriteDir|underIndicating
IsAddRenderList|executeBackslashCompound
viewSizeSelfAdaption|refersQualifying
m_showLayers|temporarySpecialization
removePlayActionWithChildrenCb|limitInttypesPromotion
m_SocketState|m_backIncluding
HideWithChildren|cardThenResideDepends
updateBloodAction|behindSpeakOperates
ColorWrite|difficultDifferentLearned
registerSetVisibleCb|compilersGeneratedWith
m_attack_mode|m_specification_Destroy
_sleepCondition|m_programmingHeld
_componentOffset|JIgExpectsDetermineOp
updateNowAnt|sequencesCommon
DefaultActionPlistPath|preventedRules
hurt_inited_idle|m_decrementsLength
m_showNameAndBloodState|dataThen
m_addTopHeadNodeToMapCb|designersRecursive4
m_touch_rect|accustomedIgnored
_remainTime|m_holdsListed
_updateContentSize|peopleLibraries2
m_instance|m_threeUnderlying
loadPlistAsync|separatesSpecifyNormally
BasePosition|redeclaresStartsRise
PetOnRide|difficultCompileChosen
walkInTheDir|compilingDerivedHappen
HandlerMap|m_groupedDirection
AsyncDownloadManager|JIgDynamicEnumerations
m_syncReplace|m_stoplightAuxiliary
m_isLoadPlisting|clause_Writing
ModeState|JIgTextqueryQuizaLayer
SelectAction|changeWestoreVerify
registerRockerCb|suchExamines
flyTmpHandler|m_makesVariable
md5_starts|storedDestroysReplaced2
m_isLoadFinished|m_bindingInstantion
m_center_node|controllingBehave
numberOfCellsInGirdView|unusualEfficiencyFirst
YScrollView|JIgPart_ConstitutesHandle
downloadFinish|completesInvalidBinds
role_main_id|m_constitutePrograms
SpriteNpc|JIgSiteChosenControl
m_rocker_dir|m_size_Namespaces
VisibleScreen|enumeratorSaleReferring
m_roledata|m_appliesImplementation
m_suddenDistanceMin|m_mustObjec
autoMoveShow|refersManagerObject
tile2Screen|itasWillLargest
rocker_loop|m_declarationNaming
Effects|JIgWorksButtonBaser
BlurRadius|accustomedLettersOverride
m_reset_display_cb|implementationFully
SpriteMonster|JIgExecutionSpecifyMG
SeedRandMap|dealingLibrariesHandling
SideTilePos|statementsUntilManaging
_cellsFreed|m_common_Numeric
FlagValue|requirementsCauseIncluded
registerUpdateTopHeadPosCb|importanceIncrement
registerTouchDownHandler|typesShouldYield
base_url_backUp|recognizeRedeclare
MainRoledata|JIgRequires_Consult
createWithSymbol|variablesSimilarlyChanged
m_scriptUnselectedHandler|recompilingIntrinsicfifth
createChain|nonreferenceThposition
deaccelerateScrolling|typicallyTypedefsExercise
m_sprite_init|closes_Denotes
m_speedPercent|m_almostThosmembers
m_touchEnabled|m_limitInadvertently4
m_isFinished|m_largestDeallocating
cleanPathByFly|indicatingWellWords
m_repTypeId|m_flipsFail
m_blood_back|variesOccasionally
successCallback|m_specifiedFiles
createDownloadDir|couldPreviouslyGave
m_isLoadTexture|candidate_Functions
ComponentByTypeAndId|representsAcross
CLuaParam|JIgCompareisbn_IandMG
needAction|m_allocation_Reside
_moveCellOutOfSight|noneDecrementPermitted
OCC_FLAG|JIgTopic_RealizeDeal
FootprintsGap|initializersDescribedRest
m_sendMsgCount|m_insertPartno
StandTime|stoppinconditionStandard
maxcut_run|m_suppliesProcesses
m_updateTopHeadPosCb|repeatConnection
addSpriteFramePlistCallBack|clauseProgramTurn
OperateLayer|JIgInadvertentlyDifferentlyIns
sub_pecent|plainLetters
InitMsgBuff|referenceMembers
m_setLocalZOrderCb|m_doesndifferRegex
scrollViewDidStopped|conditionPointerfifth
m_phantomMoveFrame|m_constantSearch
initWithDataSource|acrossMakesSelected
PositionFromIndex|rttiHandleConcept
initDependTexturePathList|assumedFailCentral
_direction|accordingBitwise
AttackModeWithChildren|diskWheneverAbove
cleanAstarPath|curlyFamilyIndependent
m_userOldMovePos|personLabels
walk_inited|indexConverts
isTouchEnabled|multiplyingFindbook
removeActionChildByTag|exitFurtherAllocation
MapOperate|threedExecutingTypedefs
MonsterId|inferThreedIllustrated5
removeAddTopHeadNodeToMapCb|executesLeadsBegan
UnToAttack|changingMoreovesomeArgs
stoppedAnimatedScroll|relyingRepresentation
AsyncDownloadState|JIgSmatchKindTool
MapBackLayer|JIgImplementsProperTool
m_cellImageSuffix|m_yieldDigits
PlistPath2|combineThrowsStayInitial
AsyncDownload|JIgEnumerators_CalculateBaser
m_currActionState|m_packSufficiently
VisibleRole|amongExerciseBeginning
m_touch_enable|m_thereMore
onSuddenFinish|extensioindicatingItself
GenerateMD5|disadvantagesGivesLeave
relocateContainer|approachSimplerLocal
addSendMsgCount|introducedAssignment
removeAllHandlers|illegalRelyingNaming
_beforeDrawCommand|followsPattern
space2Tile|adaptorsEstablishesCard
DataSource|initializedThemselves
loadSpritesPre|greaterRegularState
removeActor|reversesRelatedDivide
autoMoveShow_ex|veryHarderLimit
checkCanWalkabledTile|personBasisEven
update_pecent|m_temporariesCome3
LuaEvent|correspondCurliesGenerate2
ActionEnable|compilerFunctionality
m_select_action|m_stoplight_Invokes
syncPosToServer|willCompilationLearn
setContentOffsetInDuration|natureEscapeNames
initMapData|providedDependsApplied
_scissorRestored|m_icaseContaining
updateMove|remainStoredValues
WeaponEffectPosOffset|complicatedBrowsersSecond
ConnectNormal|preventProgramExploit
maxcut_ride_stand|complexitySignature
m_setActorVisibleCd|m_multipleFetch
main_sprite|m_existsEssentially
removeGotoDeathCb|graspSequencesBefore2
registerSetPositionCb|recognizeWherebyExecute
ride_inited|m_startPreprocessor
ResetDisplayGap|encloseBeganNonpublic
m_mapTextureList|immediatelyDesigner
SpritePlayer|JIgComplexResetModel
ActorRenderType|JIgPageEmployeeLabel
m_blockStr|four_Elements
textureKey|offerInteracts
removeHandler|latestSubmatchFour
__indexFromOffset|oargumentsOarguments1
createBaseWithCache|ignoredUninitialized
m_onloadPlay|userBitsets
flyInitPos|m_fourMachine
moveMapByPos|matchingTypeidsExist
attack_inited|m_colon_Letter
AWC_attackMode|separateLegalDecrement
m_isLoadTexturing|m_showBrackets
DefaultMapView|m_theyInitializes
ActionHide|specificationSequences
sendPointsByPath|restrictedEvaluating
IndexFromGroupAndInGroup|compareReplacesMismatched
cleanAsync|tupleMatrixWhis
BaseUrl|recompileDifficult
m_async_pvr_path|m_transactionNormally
AWC_changeActionState|positionallyProgram
m_actionOpac|withfifthMutually
gotoRevive|consistentConverted
UnSelectAction|derivedAbstractLifetime
m_spriteInitCb|holdForward
checkPlayDefaultAction|equalsWereSpecializing
removeSyncChildActionCb|tableInvalidUnusual
LuaEventManager|JIgOffsetsEqualCtr
m_syncActionCb|m_setsStrings
MainNode|versionIntroductorySimply
m_suddenDistance|m_whif_Treated
onSubThreadEnded|baseBrownYields
md5_context|JIgEarlierMubeNode
SpriteBlur|JIgPointedRewritesDeal
_entrySeed|componentsOught
registerWalkCb|overrideDifferent
m_baseOffset|m_instantiationsResources
m_actionOpac_c|thatheyDestroys
addRenderListCallBack|computationalGuide
m_toucheEventLis|supports_Factorial
ThreadSendMsg|betterCoveringAssign
removeColorGray|representation
MapSize|includeGivesBracket
m_restTime|purposeYour
resetDisplay|alsoAppliedDiscussion1
ActorActionManageC|JIgLogicallyReverseSence
move_speed|m_oargumentsWorries
start_tile|m_inform_Enumerator
readThread|algorithmCompute
FlyModeValue|concludesMubeCorrectness
m_stepTime|m_separatorCompiler
checkMainRoleTile|deleterMenuLeftLikely
fixMapPosOffset|greaterOpenPromoted
m_smalltobig|m_almostRealizing
m_beginPoint|answerPack3
m_base_cache|m_runsLeave
updateCellAtIndex|buildsReferringInfer
_touchMoved|m_whole_Copying
m_needLoadTexturePathList|m_stringthHelpful
initMagicStatus|includeShakingTreated
CMD5|JIgQuiz_ExactlyPlane
FlyModeWithChildren|westoreInttypObjects
removeCellAtIndex|storingDestroyedAccessed
CacheNum|computeSystemPosition
AWC_stopInTheTime|majorChecksUnduly
getViewRect|semicolonWithoutDoing
JustDelayCheck|representingPromotion3
initRunStatus|tightlyShareFlags
m_plist_num|consistsConventions
restoreMainRole|calculatedArgumentobjects
MsgBody|getsOverheadNone
m_touch_move_cb|m_fullProgram
YGirdView|JIgExpectRelatedLabel
m_asyncEntryIdList|calc_Temporary
ColorGray|referenceIncrementally
BigValue2Host|implementHoweveweActs
CurrActionState|assumingAdditionalVarious
m_sDirectoryName|convertsApplicable
SkillPhantomMoveEffect|JIgSmartReturnedCtr
checkVisible|containFunctions
LUA_YGirdViewDataSource|JIgLeftSupportsEffect
UserOldMoveMap|notingSaleTell
changeRePlayTypeAndResId|factorialCommon
MainRoleId|triesAvailableFacility
m_actionStateChange|m_capital_Actuasize
MapSendByte|sameOverheadFunctiwith4
changeFullShortMode|typicallyObviousOverload
m_FatherType|curliesRemains
_plsitInfo|m_looks_Pass
initAttackStatus|logicalDatsuchChparameter
_callBackList|denotesSmart
YGirdViewDelegate|JIgCandidatePreventsHelper
PrintPosError|constituentShorttyp
OpacityCustom|majorComparedOrdinarily
m_blood_bg|complexSerious
removeActionChild|articlesIdentical
m_needReleaseFrameList|m_botherIllustrate
tile2Space|againVerifyFollows
_isUsedCellsDirty|m_discussionIndicating
updateAllAddMapId|harderPointerWantSplit
playStandEffect|countsFreePreserving1
m_defaultFileName|m_booksRealize
_touchLength|m_stringth_Impact
addMoveTarget|replacesConstructorDenote
m_versionChannel|confidentAppeaanywhere
initWeaponEffFrames|approachAllowOperates
onSubThreadStarted|usableManagerExceptions
checkMapCellIsDownloaded|evaluateIndexedRationale
TimeLabel|muensureReviewSystem
DirByDirection|hidingApplication
SingleVisible|controlAfterIsbns
waitCloseReadThread|reliesUsesThreedAllow
MapRecvByte|instantiateBuildThumb
addHandler|determinedSeries
m_showState|curliesPrecedes
EncodeBuffer|introducedRangeDeletes
m_blood_pro|exception_Program
ComponentAttrsByTypeAndId|techniquesDefinedEnsures4
checkCanWalkabled|candidateComeArgument
startRocker|imagethReadyHardest
CurrentActionState|buttonElemeisPepperby2
AsyncSprite|JIgWhichDoesndifferMap
MenuButton|JIgIgnoreExonlyEffect
fixAnimDir|partnoIndexGenerates
HostValue2Big|easierReduceMenuDeclaring
maxcut_attack|m_separatelyFirst
callBackAction|refersThdefines
isDownloadingOrJob|iostreamDistinctSketch
m_renderListEntryId|m_pair_Iand
m_suddenCheckGap|abstractionUlong
addCacheSprites|tupleMinimizeCease
maxcut_hurt_idle|m_generallyChanged
m_isAutoMove|doing_Brace
insertCellAtIndex|primaryParameteaCopies
isTouchMoved|typedefsInstantiated
addCallBack|intendSpecifedBetween
m_load_all|forwardDown
_asyncRefCount|m_comparesRvalue
m_setPositionCb|m_efficient_Elem
LuaSocketState|JIgExplainWhateverBaser
IsFixAnimDir|inttypesResource
m_cache_anim_List|m_worries_Constructing
AsyncFileOp|JIgDestructorsComplexity
LoadALL|bestResponsesStrblob
ResLoadStatus|uninitializedBindingNext
VersionChannel|unequalArrowRelated
VisibleState|dimensionSectionsUnlike
CplusShowMsgID|differentSuitedOrdinary
m_is_system_font|m_furtherBeyond
removeRockerCb|tupleStillGrammar
stopMoveAction|handlingForgetPostfixGive
maxcut_attackmode_10|m_discussionWhen
maxcut_attackmode_11|m_vectorsFreind
maxcut_attackmode_12|adaptorsGeneric1
SendBufLen|differingStatementLearn
m_setVisibleCb|m_supplying_Make
OffsetPos|dereferencesAssumeStrvec
AWC_playActionWithChildren|strvecRequested
BloodVisible|memoryExplainsRequired
girdCellTouched|presentedGraspYour
m_TopComponents|m_overloadedPrecedes
LuaSocket|JIgConversionLastOp
NameAndBloodShow|generatesTpreviousRuns
moveMapByPath|returnsAbstractionPath
m_curTargetPos_tile|reviseOccurrence
m_footprintsMoveDistance|m_limitEnumerations5
checkFlyPath|pointerlikeSource
SmallToBigMode|anotherExistsAnother5
m_move_direction|m_discussionQualify
m_footprinsOpen|m_more_Rationale
ConnectIpv6|specifedPromptLinking3
IsOpacAction|themselvesRewrites
AsyncCallBackInfo|JIgStudy_AssignedLayer
ZOrderFlag|itselfStartInlined
removeUpdateTopHeadPosCb|mistakeSuppressSyntactic2
_requestMutex|m_offsetsHeader4
syncNameAndBloodShow|connectionIdentifiesWrite
screen2Space|componentsBasicAlmost
resetSpeed|thdefinesRestPreserve
applicationOnExit|containsWillRepeat
m_resReady|pushedRecursive
addCacheSpritesPre|resourcesTheifPropagates
maxcut_fly03|m_instantiatingDisallow
ViewSize|nonexistentDesignedStores
DefaultMapBackLayer|m_input_Specified
NearTiled|operationUndefined
Direction|JIgConventionSitePlane
LuaMsgBuffer|JIgFollowed_ReferenparameterLabel
changeMode|thfunctionEntireTchange
MapScale|pointerfifthIntendedPack
ProtoBody|constructorOverride
excavateToTheDir|inevitablyMovingDivide
m_actionHide|transfersTransform
addRenderListCallback|positionsConstituentAlias
m_thread_quit|m_importantNumber
hurt_kneel_inited|triggerExhausted
removeSetVisibleScreenCb|substringBlobNameThough
Commen_Direction|JIgDestructorPreciseAction
ActorType|basicsIterator
AsyncStruct|m_salesUnchanged
FollowNode|statement
CenterNode|accessibleIntended
Touch9Sprite|JIgOwhich_ComeOp
moveInTheDir|techniquesBlobptrSmaller
m_rocker_direction|charbitsSeparates
m_managerInitNum|m_forgot_Theif
_cellsUsed|m_meaningSelects
removeSetActorVisibleCd|asideHideOffsets
m_components|m_everything_Freed
initDeathStatus|equivalentthBitsetHold
setViewRect|incrementAddressVisible
ManagerByState|occurPerformanceCout
onAfterDraw|classclickAllocatesNeed
DownloadUrl|initializedCapital
IsConveyAction|stringstheAssumingLinking
SpeedRate|tupleIllustratedBoundthat
m_isLoadPlist|m_heightIntent
hideAllActionChild|fieldWilreferShareUsers
updatePosition|stillSimpleControlling
pszFileName|ceasesCharacter
PathByPos|illustrateInttypesTreturn
initFlyStatus|ownsOpenRegardlessThcall
_AppMsgFlagTo|JIgBefriendExpandMap
AttackNum|wideSomethingFrees
isDragging|reasonsManagingCompared
syncSendStateWithChildren|doingActsCallable
playAction_ex|twinMeddleImmediately
m_loadTextureEntryId|m_index_Argumepassed
m_actionOpacGap|meddleReflect
m_unAttack|automaticallyCall
targetPoint|m_whichever_Enumerations
YGirdViewCell|JIgAlways_NeedsSence
maxcut_ride_run|transactionCallpass
m_farLength|m_facilitiesExpand
DisplayMap|learnArgsConsists
addTextureSprite1|ignoredFromEnds
m_beginNode|m_contained_Greater
_blurSampleNum|throwsParametersunlike
numberOfCellsInGroup|solutionWhichForm
ActionWithChildrenType|JIgLargerSynthesizesSence
m_map_allAdd|privatecopy_Equivalentth
addPhantomMoveEffect|specificImplements
m_stand_times|m_classclickStrategy
initHurtKneelStatus|limitExecuteExercises
suddenToThePos|indicesProcessing
_successCallback|knowledgeIdeasDistinguish
m_time_label|m_conventionReset
m_rotateDrct|arguments_Nonreference
_needRelocateContainer|caltoGenerally
LeftTime|becauseShowSchema
m_justDelayCheck|m_allow_Instantiate4
rocker_loop_max|m_initializes_Implements
registerDownloadSucCb|firstLearnSmaller
AsyncJob|JIgNeitherTakingTool
m_touchType|addedMemory
m_auto_clean|m_doubleprecContent
_deltaTimeTmp|m_suppliedQuiz
initRideStatus|argumentCheckSpecializing
_selfAdaption|m_suspendedMatched
_container|m_harderLegal
MsgBodyLen|realLogicalHidingMust
_AstarNode|JIgEncapsulated_SimplerControl
ActorFlag|storedNoneAuthorMutually
actiontime|m_legalExchange
death_inited|m_pointers_Functiopresented
AWC_flyState|contrpassesLittleArrow
m_allShowWithoutCheck|string_Person
PlistsNum|destroyingGaveTaking1
maxcut_weaponeff_10|better_Dealing1
FlyMode|selectedBlobSynthesize
m_offsetPos|m_explainIndex
maxcut_fly01|m_addedRepresentation
maxcut_fly02|m_siteType
m_curTargetPos|m_advantagesKnowledge
m_resSuffix|presenceTrivial
registerSetOpacityCb|nonmemberSucceedsWould
registerSuddenCb|callpassDebuggingFuntion
playAction|acrossTimesWriting
SpriteGuard|JIgAttemptedManyIns
FontChina|JIgUnformattedFurtherControl
EntryId|buildsEyesThosmembers
print_storage|implementsIncrementally
updateJoystick|directlyEncapsulates
m_footprintsGap|m_bindsBind
resetDisplayGap|changeAdvantage
_asyncStructQueue|chparameter_Give
_addCellIfNecessary|bitwiseElementsVery
playerAttackToPos|objectsthRegularForm4
stopRocker|limitCompletelyTedious
MainSprite|beginningPushedMube
syncKeyPosToDetailMap|workLongerStringLimit
ActionStateChange|bindsLabeledLooth
CenterItem|sameTemplatesLabels3
groupCount|subsequentFreeNestingBase
ShowTag|lettersEmplaceAppears
LuaEventExEx|candidateWregexOrganize
Commen_ActionToDo|JIgWefifthAdvantagesDeal
sendPointsByAstarPath|usedCallSupply
initWithFileExt|nonmemberException
ActorRenderQueueManage|JIgKindsThexercisesLayer
m_pszFileName|shownTakes
registerTouchUpHandler|freedComplexSupplied
_progressCallback|serialCoverageNodefault
popLongLong|comesIntoAffectFocus
doStreakToTheDir|indexingLessTold
s_sendMsgBuffEx|usableHaving1
OnRideId|preferredSimilarlySimilar
flyTriggerList|m_illustratePreceding
initCheckFlg|alsoEssentiallyUntil
m_OutsideBodyComponents|m_relyDatsuch
removeComponent|numberedNamingThcall
m_isActive|m_informationRequested
YGirdViewDataSource|JIgGuaranteeDependsEffect
registerSuddenDistance|referenceDetailedIllegal
VisibleCustom|addingNestingNature
YScrollViewDelegate|JIgLockResideMG
_blurRadius|intendingFunctional
MapView|JIgInto_IdeaIns
ActorId|typeAccessedForcesTend
flyToTheDir|temporaryStopsSure
calculateAssetPath|separateLeavingEnds
m_fly_mode|representsControls
_parentScissorRect|m_executeChartyp
m_monster_id|m_defined_Rise
loadFlyTrigger|prefiBrieflyPredicted
TouchType|extensioindicatingVerify
initAttackModeStatus|interpretedCalto
m_loadPlistEntryId|m_avoidArticles
removeSetPositionCb|makeLearnMistake4
DecodeBuffer|nonreferenceBitwiseThey
MakeNumbers|JIgSpaceReadyCtr
pushDataByString|ostreamEvaluateSerial
attackOneTime|contentExplainReason
dir_next_tile|m_surprisinglyExecute
NameLabel|precedesSimplyOwns
m_numsCache|localWhatever
SendMsgCount|errorsPromotionLifetime
maxcut_stand|m_therePromise
LuaEventEx|nodefaultDetermined
m_show_plist_path|m_threedDefining
ShowTexturePath|thoughLittleAdaptorsFree
m_center_pos|m_same_Logically
LUA_YGirdViewDelegate|JIgDesigners_IteratorsDeal
girdCellAtIndex|bypassDoneFollowFreed
m_suddenTargetPos|m_predictedPrints
FootprintsOpen|comesEnumerations
createToTheDir|sourceVariableFullExtend3
TileByDir|seenInformationSignals5
moveMapByTouch|actuallyExistingError
CenterPoint|tryingEnsuresQualifying
AttackMode|affectsThoughPreserve
updateShowState|precedenceNeedingRecent
m_name_label|lettingSucceeding4
GroupAndInGroupFromIndex|ordinarilyOptional
registerGotoDeathCb|resourcesSubmatchWhen
IsFinished|analogouslySketch
_m_touch_time|m_encapsulationAndquery
registerMoveKeyPosCb|destroyingInputPromise
systemMoveRoleToPos|althoughDefinedUnchanged
MapSpan|listExceptionData
ShenbingStatus|pointerlikeStunningly
addTextureSprite|accessScreenContainer
scroll2Tile|executedScopedCompletely
removeSuddenDistance|ruleWordsOtheBehaves5
digToTheDir|dereferenceInitializthe
m_delaytime|m_leave_Cmatch
ShortMode|namespacesExpectsCeases
DirByTile|manyWhereby
ActionState|JIgPossibly_SeparatorSence
checkMovePos|ensuresEnableCompareisbn
DirectionByDir|recompilingDecrement
StFPSlog|JIgEncapsulationAspectsDeal
_responseQueue|specify_Pass
m_showNums|m_localDirections
onSubThreadLoop|simplyPointsDoneManual
DisplayStatus|higherRuleConstitute
m_noMove_cb|m_constantAbout
OnRideWithChildren|findSpecifiersTreated
AttackModeC|spaceDatsuchFlows
m_setOpacityCb|m_predictedOmitting
m_setWhiteCb|m_prohibit_Leads
initAttackRushStatus|separatesProperties
updateOpacityAction|rationaleLevelTends
m_showMsgID|m_version_Essential
m_speedRate|m_selectsTakes
ShowLayer|exclusiveVariable
maxcut_attackmode_09|m_graspWell
maxcut_attackmode_08|m_realizeColor
maxcut_attackmode_07|m_skipItem
maxcut_attackmode_06|large_Average5
maxcut_attackmode_05|m_techniquesSoon
maxcut_attackmode_04|violationsNontemplate
DirIDByDir|generatingWithCovering
maxcut_attackmode_02|stringthBrown
maxcut_attackmode_01|devotedPartially
TouchSprite|JIgWhisShorttypLayer
m_center_item|m_needingFigure
BloodType|heldBlueprintLegal
calculationArrival|preventsApplicationsTurns
HandlerType|JIgFixedWillMG
m_downloadListenerList|rationaleOarguments
runLuaFunc|determineCompatible
checkMapIdInAllAdd|doesndifferNonreference
m_plist_loadnum|m_thpositionCurrently
errorCallback|m_emptyEarlier
s_sendMsgBuff|m_flowsNormal
showNameAndBlood|findingAsking
m_petOnRide|m_constructingAgain
m_viewRect|afterFunctiwith
m_nameSize|m_possiblyThoutermost
SuddenSpeed|limitedPeppersSurely
s_recvMsgBuff|m_compilationReport
_objAttrs|JIgCandidateSubscriptOp
hurt_inited|infrequentlyPrints
DirByNowPoint|strictlyComputingPass
NameSize|expandMadeSignatureTuple
m_sudden_cb|m_equality_Chapters
_requestQueue|m_implementationBehalf
_DisplayNode|JIgBitsetTendMap
_responseMutex|m_usefulDown
addComponent|stopDebugdeleteWorkAkin
MaxReadCount|increasedAppropriate
m_managerList|arrays_Implements
progressCallback|m_variadicReset
AWC_setActionStateChange|bypassIstreamExplain
doOpacityAction|friendshipTableMove
m_auto_clean_cache|lengthItem
copyMainRole|iteratorsCeasesParametis
insertActionChild|removedDeletesTreats
removeSpriteInitCb|knowledgeKnownCalculated
ConveyState|aggregateComeFunctional
girdCellHighlight|requirementExecutedSearch
m_random_mode|m_involvedWarrant
cleanOtherActor|presumablySpecialization
sendSocket|realDevelopedControl
_errorCallback|establishesCallsElipsis
md5_finish|comparingCharactershaving
run_inited|m_properlyNodefault
cellSizeIdentical|addressTellsDetermines
m_shenbingStatus|m_finds_Count
convertMapPos2EdagePos|findbookItemImportance
md5_update|containDefininsideColor
repSpritUrl|m_intendErrormsg
m_componentsAttrs|wantsInfer
AppMsgHead|substringRewriteCopies
m_start_point|m_efficientNonconst
isactor_flag|preventingFacility
maxcut_weaponeff_11|m_forgotDefine
playActionWithChildren|compareisbnAendTpass
m_isFixAnimDir|ellipsis_Actual
auto_download|levelRegardless
maxcut_magic|m_factInstantiate
m_isAstar2Finished|m_extendBlobptr4
m_suddenSpeed|m_whose_Shows
m_show_texture_path|betterReplaced
PageIndex|detailedResulting
registerTouchMoveCb|recentIntoException
removeSetWhiteCb|needsUsableInitialize
m_conveyState|m_aliasesInttyp5
addTopHeadNodeToMap|placedRedeclaresWith
m_is_right|m_identifiesGrasp
m_setWhiteComponents|complexityEqual
LuaBuffer|executingUndulyOnly
girdCellUnhighlight|benefitIndicatedGets
_loadingThread|m_sense_Parentheses
m_onRide_id|circumstancesAround
m_followNode|m_somewhat_Insert
shadow_sprite|m_promotes_Something
asyncEntryIdCallBack|patternsControlDoeth
m_isInRenderList|m_brownEnclose
m_syncPosGap|declarationWorth
_m_move_time|placeComputing4
registerResetDisplayCb|postfixEncountersDeletes
openSocket|nonstaticThatheySeemingly
ShowBloodAnim|buildsTheifInstantiates
m_pszFileNameList|m_cannotRunning
_cellsInGroup|m_twinContainer
_objRender|JIgOpposedOpenModel
BtnContainer|JIgFocusInstantionModel
PageByIndex|bracketsContents
findTriggerByPoint|functionalthoughFact
m_gotoDeathCd|deletes_Appropriate
m_checkOpacityMoveDistance|m_then_Organize
_indexFromOffsetInGroup|thoseIncrementsRevised
syncFlyStateWithChildren|containerImportanceTreat
DirByNewPoint|declaringProcessTreat
_updateCellPositions|importanceTermsDesigner
m_suddenCheckGapMax|expectPromoted
removeTouchMoveCb|declarationsViewPuts
updateZOrder|definitionPermittedMoving
cleanDenpendFrames|mimicLimitSelect
maxcut_hurt_kneel|m_allocated_Prevent
maxcut_weaponeff_12|versus_Translate
hurtIdleToPos|baseProperIterator
AutoInfo|heightTightlyMachine
registerNoMoveCb|addsConstructorsOwhich
AWC_flyMode|basedPeriodDiscussioof
m_actiontime|referShorttyp
LabelChild|facilitiesEncapsulated
removeMoveKeyPosCb|correctnessInitializthe
initHurtStatus|keywordOmittingEarlier
initHurtIdleStatus|involveExchange
initGLProgram|containingValidWrong
_touchPoint|m_widthCopy
addWeaponEffect|deducesVersionWere
stopMainSpriteAction|differsBoundSynthesized
registerFlyCb|thdefinesTargetBlock
createEffect|generatedInvokesCurlies
m_isBloodVisible|brieflyApplies
initStandStatus|thoutermostCouldCalls
maxcut_death|almostBitwise
FatherType|instantiatingCopyingMain
AsyncPvrPath|identificationComplex
AWC_conveyState|behalfEmployeeBlobptr
m_actionOpa_state|m_isbnsTable
LabelNodeC|JIgMajorNumbersLayer
OutLineColor|partialIncludingSingle
m_title_label|valueReduce
removeFootprintsCb|saidImplementTchange
roleMoveOnMapByPos|lookComplicatedUnrelated
MoveDirectionUpdate|wregexNamingAuthor
IsRepMode|behindTransactionsExpects
is_getData|m_ninesExist
unbindPlistAsync|causeResideDealing
MOVE_CHECK_GAP|m_subsequent_Inefficient
girdCellSizeForIndex|kindPersonIntent
initWithViewSize|zeroAllowsNonreference
scroll2Pos|tokensUnequal
registerSetVisibleScreenCb|unlikeDenotingOuter
maxcut_hurt|accumulateHappens
RestoreFirstFrame|intendingWhsuggestDestroy
addColorGray|defininsideNothing
GraySprite|JIgLeaving_DeductionAction
screen2Tile|factorialWhatString
girdCellWillRecycle|currentlyGuarantee
PlistPath|bookstoreBasicsWhenever
m_footprintsCb|generalAdvantage
m_boSkillEffect|turnResolves
m_customlistener|replacementHappens
m_downsuc_cb|executesCommon
MsgID|JIgFacedRightLabel
_plistInfoMutex|m_backslashAbstraction
