strbuf_t|neitherNamed
checkFlyAutoPathTarget|compatibleTechnique
attack_rush_inited|m_omitsCompilerTilde
addMapSprites|reallyDescribedPermitted
m_isAstar1Finished|m_helpfulExploit
ActionName|muensureConstitute
showJoystick|indicatedHardPrecedence
ActionTag|streamConstitute
_afterDrawCommand|m_ignoredLongerGiven
ByteBuffer|typeinfoHandledPattern
m_setVisibleScreenCb|m_movingLengthLimits
triggerPoint|fairlyBrace
maxcut_weaponeff_02|m_expansionGuideStarts
onRoleMoveFinish|includesSelectsPuts
maxcut_weaponeff_01|m_disallowLvalueRationale
maxcut_weaponeff_06|m_recentQuerySquares
maxcut_weaponeff_07|m_definedMeansNines
maxcut_weaponeff_04|m_destroywhen
maxcut_weaponeff_05|computingDistinguish
IsLoadFinished|programmerAccessVarying
maxcut_weaponeff_08|m_treatsWantTimes
maxcut_weaponeff_09|m_savedCerrRationale
registerPlayActionWithChildrenCb|somewhatDerivedDetail
m_autoTime|theifLastSupplied
md5_process|variadicPointerMade
changeState|updatesProvidedDefines
removeRenderCallBack|searchContainPeople
removeActionChild|availableKindThosmembers3
TouchEnabled|messageDescribeInvalid
registerSetLocalZOrderCb|implementsBaseWell
stopInTheTime|positionedDynamic
RockerDirection|inspiredPresumablySurely
maxcut_attack_04|m_longtypSeenItself
AsyncSpriteState|revisedButton
maxcut_attackmode_08|chosenIdentifyingTheir
MaxLineWidth|instantiatingAlmost
addSpriteFrameListCallBack|askedBlobChain
maxcut_attack_03|machineWish
registerSetWhiteCb|thingsAutomatically
MAP_SPAN_X|m_createdDefinitions
MAP_SPAN_Y|m_definitionsProblem
registerSyncChildActionCb|resultOccasionallyOnbits
_FlyTriggers|emptyTuples
m_ActorComponents|m_directInefficientDeduced
copulationNumber|argsNonreferenceEither
resetSpriteAct|statementMacroMaking
m_needLoadTextureList|preventingBother
registerSetActorVisibleCd|conversionResult
inGroupCount|removedPowerfulConstruct
m_ischecking|m_knewUses
retainMainRole|destructorObjectsthNodtor
convertRoleMovePosToMapPos|indirectBlueprint
stand_inited|rttiSpecifedMuch
m_checkResType|m_matchesProperlyExpansion
maxcut_attackmode_03|wantBoundthat
m_visibleState|executionApplication
ClipboardHelper|controlElemeisLooking
isTouchInside|understandingThough
m_showBloodAnim|m_machineCreatedRtti
m_syncPosMoveDistance|fithatAutomatically
m_checkOpacityGap|m_gradesFlags
BlurSampleNum|exploitFindbookBrown2
updateTouch|allocatesPromotionBracket
m_unselect_action|m_reversesMovesEnds
m_async_pvr_path|m_buildSeesLocal
PrintPosError|saidSizeConstruct
removeAddTopHeadNodeToMapCb|pointsSurelySupport
m_boPhantomMove|representObjecDirection
SocketData|schemaParentheses
m_renderList|contrpassesExpect
canShowNormal|builtOtheConsis
IndexFromPoint|placedSynthesizesGrading
autoPathFlyTargetPos|applicationContaianyTurns
ShowPlistPath|pointerfifthManual
WsThreadHelper|m_doubledFetch
scroll2Tile|authorMuensureAppear
preAsyncLoadImg|whversionPossibleCreated
collideInTheDir|classclickBypassArgument
m_targetPosList|m_mistakeBeganInitialize
playActionData|precededFifthHandles
registerAddTopHeadNodeToMapCb|includePreferredBrowsers
s_sendMsgBuffExEx|m_contaianyFactorialTest
AWC_setOnRide|accessBoundthatCoupled
closeSocket|wcannotIobjThrough
m_mapScale|m_willOperations
stopMapAction|restrictionsWorriesItself
removeWalkCb|processingReference
maxcut_weaponeff_03|m_scopingAendSays
pushLongLong|endsContentsWidth
fly_inited|curlyNodefaultUnderstand
initDataAndFunc|existingTellDereferences
removeSetLocalZOrderCb|optionalThatHeader
ScreenVisible|frontThroughoutBlobptr
addSpriteFrameListAsync|legitimateReferAlso
performedAnimatedScroll|functiwithGroupFamily
magicUpToPos|postfixInheritDirection
scrollViewDidZoom|appliesThanTime
onMoveSpeedChangeAction|reviseEquivalentth2
OpenActionCheck|opposedPrecedeLogical
TouchType|enumeratorsRealAproblems
numberOfCellsInGroup|differenceCondition
m_screenVisible|m_pointCompareEach
moveMonsterByPos|protectionFormBestSelects
hurtKneelToPos|likeBookstorePeppersData
removeSetOpacityCb|stringthDestroywhenReason
changeFullShortMode|exerciseListsWestore
SkillCtrl|appliedDoubleprec
ODSocket|connectionDeleterBefriend
beginAutoAct|approachHavingContents
stopMonsterByPos|queryInevitablyDevoted
WhiteCb|wcannotRunsBehalf
ShowHeight|strictlyWheneverPrevents
m_scriptSelectedHandler|m_plainAbout
m_currMode|m_varyingEverythingIncluded
m_isOpacAction|m_computationalVectors
m_moverPoint|m_databaseOther
scrollViewDidScroll|unusualTheyDecrement
FullMode|afterUnchangedSuspended
hasVisibleParents|implementingEnable
removeResetDisplayCb|moveAvailableRationale
SHOW_STATE|callAssumes
m_needSyncPosToServer|m_appearRecursiveAssumed
m_restoreFirstFrame|m_wordInstantiates
changeStateWithChildren|precedeAroundHere
m_actorType|resolvesHigh
TitleLabel|bitsPrecedenceTurns
m_monster_id|omitsLoop
m_playActionWithChildrenCb|escapeTryingTesting
getContainer|charactershavingBother
PlistNum|persistRecognize
cellSizeIdentical|rightNormallyProgram
NeedSyncPosToServer|bodiesEmptyNonexistent2
hideJoystick|escapeOverloadPrevent
hasBlockAlong|correctAssignsConstitute
m_OnBodyComponents|m_explainingRuleDestroys
_m_stand_time|m_advanceMarkAssumed
hasBlockPos|aproblemsThingAsfifth
isLoadFinished|anglePrimerTendsVaries
beforeDraw|blueprintOmits
addAutoRemoveAction|charbitsStoresSeparator
loadPlistAsyncCallBack|dynamicSomethingUnchanged
unbindPlistAsyncWithEntryId|specializesSubscript
onUIThreadReceiveMessage|constexprManagedChapter
SpriteBase|everythingOnbits
registerFootprintsCb|bodiesCorrectlyPrograms
_vCellsPositions|m_reachHenceNoted
IsResReady|guaranteeRealCalto
space2Screen|willScreenComplexity
registerSpriteInitCb|bitvecEncapsulate5
attackToPos|accustomedWhenExpand
_indexFromOffset|delegatesPrecededChange
m_weaponEffectPath|m_specifedKnown
BaseAnchorPoint|insertReturnsTarget
_setIndexForCell|returnsTpassConstructor
m_isAddRenderList|attemptPastLogical
NowActByDir|assumedPropagatesLittle
showAllActionChild|delegatesBestModel
relocateContainer|appearComesSuited
CurrectDir|collectionSoonViolate
WeaponEffectPath|countsFindingErrorsOthers
ParentReorderChildDirty|encapsulatePerform3
AsyncLoadPlist|generateDifferingPrinted
IsSystemFont|safelyCertainSuppress1
MainRole|aliasEntireConstraints
cczPlistData|namingInteractionLooks1
_scrollDistance|m_keywordKindsHeld
_loadingThread|m_peoplePushReflect
m_openActionCheck|lockKnowNormal
SpriteType|widePrintIterator
resetPosByHead|freedNeitherStop
m_moveKeyPosCb|m_incrementingCmatch
girdCellLongTouched|explainingContract
OutLineSize|tableSpecifyMatches
onBeforeDraw|limitNecessaryDealing
maxcut_weaponeff_11|m_missingLinking
calculateOffset|unlikePreviouslyTopic3
SpriteDir|streamThumbAdvanced
IsAddRenderList|rttiLatestGenerating3
m_showLayers|m_offsetsInstantionSkip
_objAttrs|indexedSuobjects
removePlayActionWithChildrenCb|separatelyAllocates
m_SocketState|m_computationalActsPreserve
HideWithChildren|executeHardPreferred
updateBloodAction|multidimensionalOver
ColorWrite|advantageDetermineSystems
registerSetVisibleCb|ninesEnclosedFigure
m_attack_mode|m_availableApplyMatrix
_sleepCondition|akinRunning
_componentOffset|slowPrecedes
updateNowAnt|assumeIntendDeduced
removeActor|existsZeroPepperby
hurt_inited_idle|blobptrEnforces
m_showNameAndBloodState|endsCurrently
attack_inited|sectionPreventing
applicationOnUpdate|operandsOccurrence3
m_touch_rect|associativeCallingWhif
_remainTime|explicitlyPrograms
MapSize|realizeRequiredData
maxcut_fly03|anotherSynthesize
loadPlistAsync|coveringValueDirections
cczPkmFile|wantFailsSynthesized
BasePosition|initializations
pushDouble|opposedDifficultThrough
PetOnRide|recognizingTrying
walkInTheDir|peopleFuntionPropagates
AsyncDownloadManager|initializerPatterns
m_syncReplace|continuesAppeaanywhere
m_isLoadPlisting|m_majorStream
ModeState|alsoSelectedDetailed
SelectAction|contadeclarationsPeppers
registerRockerCb|groupedTransaction
ProtocolPacker|diskCircumstances
doStreakToTheDir|respectiveWhichOccurs
flyTmpHandler|m_algorithmSuppress
md5_starts|arrarecallCoupledJust1
m_isLoadFinished|m_failsMenu
m_center_node|curlyTriggerTransfers
numberOfCellsInGirdView|describeVariableBasicFree
YScrollView|programmingThink
downloadFinish|tpassDecrementPurpose
role_main_id|deletesCompute
SpriteNpc|difficultRise
m_rocker_dir|printingAbsoluteFewer
VisibleScreen|includeCertain2
m_roledata|m_widthCharbits
autoMoveShow|offerTypesEssentially
tile2Screen|expectCacallTypes
rocker_loop|m_pushedAhead
Effects|expandEnclosingCorrespond
BlurRadius|stringstheDebugdelete
m_reset_display_cb|m_conversionAttempted
SpriteMonster|specializationsCurrently
SeedRandMap|restrictionsOarguments4
SideTilePos|operatorclickProcesses
_cellsFreed|m_recognizingElemtypeWorry
FlagValue|wantsSaidEitherExamines
registerUpdateTopHeadPosCb|initiallyFlipWarrant
AWC_setActionStateChange|flipOstringstreamLiterals
registerTouchDownHandler|messageExpandWhich
base_url_backUp|respectiveSomewhere
MainRoledata|thgeneratesFocusKnown
createWithSymbol|happensPrintInvolved
AttackNum|employeeRationaleMessage
m_scriptUnselectedHandler|tellInteraction
AsyncFileOp|requireComponents
createChain|befriendThirdConceptually
deaccelerateScrolling|resolvedRecentLoops3
m_sprite_init|sizeAlgorithmsReduce
m_speedPercent|synonymResultingSyntactic
m_setPositionCb|m_followedPersonSemicolon
CenterItem|thingOrdianaryParameters
m_touchEnabled|messageSpellingEqually
successCallback|m_patternExtend
m_isFinished|thoughSpaceElement
cleanPathByFly|valueduringIntuitive
m_repTypeId|m_restRunningArrays
m_blood_back|m_conditionOperators
registerTouchUpHandler|needsNumberedBound
createDownloadDir|otherLimitDiscussion
m_isLoadTexture|numbersPush
ComponentByTypeAndId|packStudentOlder5
HandlerType|assumingRepresenting
needAction|m_reverseExistingViolations
_moveCellOutOfSight|setsAlsoPermitted
OCC_FLAG|selectsDeclare
FootprintsGap|discussionRoomEncapsulate
m_sendMsgCount|denotingExpectations
StandTime|unchangedNothing
maxcut_run|usuallyCalls
_needRelocateContainer|m_namesBookstoreAdvance
addSpriteFramePlistCallBack|illustrationHelpful
OperateLayer|simplyIncludingMessage
InitMsgBuff|bypassInstancesFlags
scrollViewDidStopped|stopsMemberwisePreserving3
m_phantomMoveFrame|overrideCorrect
m_delaytime|m_assigningReallocates
initWithDataSource|rolesOperationDelegates
MainSprite|pairwiseDestroyedWidth
initDependTexturePathList|defininsideAlternatively
_direction|reusedRevised
AttackModeWithChildren|appeaanywhereManagerTends
cleanAstarPath|consistsSelectedCout
m_userOldMovePos|correspondDestructor
walk_inited|m_matchesFunctionality
isTouchEnabled|naturallyCreatedTarget5
removeActionChildByTag|bitwiseReportRoom
MapOperate|whichNumericRejectRanked
MonsterId|forgetFollowingActions3
checkSuddenDistance|imagineLikelyCalledFollow
UnToAttack|almostMatchingResource
stoppedAnimatedScroll|wantOverloadSupply
AsyncDownloadState|pointThpositionTempting
MapBackLayer|illustrateUniqueFront
_responseQueue|relyingEfficiencyOriginal
m_cellImageSuffix|movesBookstoreEven
YGirdViewCell|inputBecauseRequirements
PlistPath2|beyondLimitedData
AsyncDownload|throwsClearOriented
m_currActionState|m_declareTpassHandled
VisibleRole|constructMistakeConsis
m_touch_enable|m_reflectConvenient
stopMoveAction|realListthGuide
onSuddenFinish|enumeratorsTuplesPoint
GenerateMD5|expectHelpfulCorrectness
removeSetVisibleCb|continuesRelational
addSendMsgCount|thexercisesProcessesTheir
removeAllHandlers|instantionDifferenceThus4
_beforeDrawCommand|m_relationalEnsures
space2Tile|mattersFlipsSample
DataSource|redefinitionInitializes
updatePosition|iteratesLikelyOfile
loadSpritesPre|spellingThatheyBasis
DefaultActionPlistPath|listitemTokensSensible
autoMoveShow_ex|valueRecompileDeletes
checkCanWalkabledTile|instantiatingSufficiently
update_pecent|selectsAdaptors
LuaEvent|intendThroughNonvariadic4
ActionEnable|replacementDetailedStill
m_select_action|multipleReuseMatters
syncPosToServer|majorTemporariesAutomatic
setContentOffsetInDuration|nestEmbodiesLeave
initMapData|brieflyMightGivenUnduly
_scissorRestored|m_extensionsNatureVariables
updateMove|generalStoppincondition
WeaponEffectPosOffset|memberMeanHiddenNeeds
maxcut_ride_stand|multiplyingDistinguish
m_setActorVisibleCd|m_associativePublicly
main_sprite|listedRealizeCalls
removeGotoDeathCb|knowsScopesImplicit
registerSetPositionCb|objectsApplications
ride_inited|m_tpreviousSubsequent
ResetDisplayGap|specializedDefining
m_mapTextureList|handlingExecuted
SpritePlayer|dereferences
ActorRenderType|transactionIgnored
m_blockStr|m_cabeEvaluatesConversions
textureKey|m_serialJustDevoted
removeHandler|enumeratorDoubledCombine
__indexFromOffset|leaveLvalueRegardlessText
createBaseWithCache|giveFailFlips
m_onloadPlay|uninitializedBrace
flyInitPos|duringInefficient
m_numsCache|m_drivenSeparated
moveMapByPos|charbitsPresumablyWrote
m_addTopHeadNodeToMapCb|strcmpImpactApproach
AWC_attackMode|exactlyVerifiesComplex
m_isLoadTexturing|m_otherwiseValue
DefaultMapView|pscreenValidAppears
ActionHide|suobjectsCircumstances
sendPointsByPath|pastConfusedEvery
IndexFromGroupAndInGroup|wefifthNonpublic
cleanAsync|curlyExpressionasCerr
run_inited|m_howeveweHandled
SpeedFloatPercent|parametethatAroundTries
AWC_changeActionState|derivedDirections4
m_actionOpac|performGives
gotoRevive|accustomedBehaviorArray
UnSelectAction|meddleSupposeparateHigher
_isUsedCellsDirty|m_saidParameters
checkPlayDefaultAction|stillEcmascriptCompanion
removeSyncChildActionCb|fromLeftExpression
LuaEventManager|justIncrement
m_syncActionCb|m_indicatedAdaptorsWhere
MainNode|resolvedGroupedSyntax
m_suddenDistance|m_accessQuizWilrefer
onSubThreadEnded|positionedRunningNodtor
md5_context|suobjectsPairsAvoid
YGirdView|aggregateDevoted
SpriteBlur|matchedIndicesAddition
_entrySeed|m_nameIsbnsRequires
registerWalkCb|fonumberClearVarious
m_baseOffset|m_lessForgetAlthough
m_actionOpac_c|m_constructingMaking
addRenderListCallBack|goodImpactSucceeding
ThreadSendMsg|imagethIndexedRemember
removeColorGray|treatedLocalTechnique
_updateContentSize|designerCleansLibrary
sub_pecent|m_lengthRolesThposition
resetDisplay|linkageWorkIostream
m_instance|m_replacesClosesComplexity
cczPlistFileDir|remainingCoveredThus
ActorActionManageC|assumeMoreovesomeAssume
move_speed|supplyingDiscussioofSkim
start_tile|especiallyProgramNumber
readThread|nocopyThgeneratesReady
FlyModeValue|userListedNeedsBehind
m_stepTime|m_denotesEspecially
checkMainRoleTile|objectElemtypeHasptr
fixMapPosOffset|forgotPresumablyThat
m_smalltobig|m_differenbetweenOarguments
m_beginPoint|m_interpretedValueduring
m_base_cache|m_underlyingRewrites
updateCellAtIndex|limitationSupplies
_touchMoved|simplerRepeatedly
m_needLoadTexturePathList|m_realEntry
initMagicStatus|nontemplateFallVarious
CMD5|abstractExpression
FlyModeWithChildren|neverToolsDisallow
removeCellAtIndex|likelyProhibitVariable
onSubThreadLoop|freedPreferredParameters
AWC_stopInTheTime|insideRememberBooks
JustDelayCheck|contaianyAcrossTedious
resetSpeed|permittedEssentially
initRunStatus|strvecLockMade
m_plist_num|m_genericCease
restoreMainRole|attentionListitemFacility
MsgBody|bookstoreImplementation
checkFlyPath|flipsDecrementDesigner
BaseUrl|inspiredDeduceTchange
m_asyncEntryIdList|doubledResourceRecursive
SmallToBigMode|consistsPointsunlike
ColorGray|becomeOwnsDeclare
BloodVisible|beenIndependentlyMultiple
m_center_pos|m_enumsDigitsObjectsth
CurrActionState|multidimensionalLeast
m_sDirectoryName|m_bestDecrementsElemeis
SkillPhantomMoveEffect|functionInterchangeably
checkVisible|independentWordStringsthe
LUA_YGirdViewDataSource|infrequentlyEmpty
UserOldMoveMap|needEncapsulatedSize
changeRePlayTypeAndResId|pscreenNotingIterators
MainRoleId|debugdeleteModifyFollows
MapSendByte|correspondParameteth
loadMapStr|exactGranting
m_FatherType|m_programmerConsiderStrvec
_plsitInfo|usefulTediousFonumber
initAttackStatus|enumeratorLimitsCoupled1
_callBackList|aroundFreind
YGirdViewDelegate|complexityMeans
registerGotoDeathCb|findingHappenDepends
m_blood_bg|m_resourceNodefaultErrors
m_zOrderFlag|m_relevantEvaluating
m_needReleaseFrameList|structureResolves
tile2Space|entireFriendshipfifth
m_spriteInitCb|m_shorttypComplicated
updateAllAddMapId|enumerationClearRecursion
ConnectIpv6|interactionPrintingOutput
playStandEffect|followingSomewhatTypes
m_defaultFileName|distinctEquivalent
_touchLength|m_succeedingWish
addMoveTarget|normallyCaltoBeginsHidden
m_versionChannel|recentSpecifyBegun
initWeaponEffFrames|predicateTransactionStore2
onSubThreadStarted|variableFriendshipOften
checkMapCellIsDownloaded|relationshipExceptWorks
TimeLabel|copiesCmatchMistake
DirByDirection|becomeFunctiwithFetch
SingleVisible|featuresRunningUnless
waitCloseReadThread|complexitySureConfident
MapRecvByte|facilityHeaderPrevents
addHandler|instantiatedVaries
m_showState|recognizeSubscript
EncodeBuffer|delegateInteraction
m_blood_pro|m_commonExamines
ComponentAttrsByTypeAndId|variablesIndicatesLinkage
checkCanWalkabled|packParametethat
startRocker|basicsMeddleIntegral
CurrentActionState|bitsObtainLoopParametis
AsyncSprite|easiestHide
MenuButton|systemAffectLargest
fixAnimDir|heightAddsVarying
HostValue2Big|quizInstantiations
maxcut_attack|m_readUndefinedparameters
callBackAction|randomMakes
isDownloadingOrJob|effectivelyAssumes
m_renderListEntryId|thoutermostProcesses
m_suddenCheckGap|m_helpWrote
addCacheSprites|neitherFreindExist1
maxcut_hurt_idle|m_creatingVarying
insertCellAtIndex|countsPartsLimit
isTouchMoved|initiallyDatabaseDirectly
addCallBack|avoidAbleWhole
m_load_all|m_againAnswerWhappears
VersionChannel|reusedDoubleprec
getViewRect|sequencesFiveDesigner4
LuaSocketState|conceptUsers
IsFixAnimDir|otheAlgorithmsContents
m_cache_anim_List|m_storesAllocationTokens
copyMainRole|directFirstShaking
LoadALL|qualifyingTheseKnows
ResLoadStatus|specializationPreferred
VisibleState|printLikelyIostream
CplusShowMsgID|showsStyleValuelike
applicationOnExit|cmatchEndingOverride
m_is_system_font|m_ctypeDescribes
removeRockerCb|systemsVariabandGives
ManagerByState|nearlyImagineReal
TouchEnable|literalMeanBitset
maxcut_attackmode_10|doethAvailableUseful
maxcut_attackmode_11|m_inheritanceSubstring
maxcut_attackmode_12|m_recognizingDoesndiffer
removeSetActorVisibleCd|blobptrHighestDynamically
SendBufLen|referenceErrormsgOrganize
m_syncPosGap|fixedProperties
m_setVisibleCb|m_printsSoonInitialization
OffsetPos|currentSpecializeFull
AWC_playActionWithChildren|techniquesEstablishes
m_stand_times|m_alphabeticThan
girdCellTouched|structureUninitialized1
m_TopComponents|m_skimMain
LuaSocket|choiceWithoutBuilds
NameAndBloodShow|allocationElemPerformance
moveMapByPath|seriesSaidHelpful
m_curTargetPos_tile|writtenAgainVisible
m_footprintsMoveDistance|referencesthCloseDeleted
m_actionStateChange|m_shouldHardArea
_DisplayNode|fiveInitializthe
m_move_direction|m_thingsDeleterRecord
m_footprinsOpen|confidentCorrectly
m_suddenCheckGapMax|m_theirFlag
IsOpacAction|computingEcmascript
AsyncCallBackInfo|associativeOccurAndquery
ZOrderFlag|managingWcannotSeparator
removeUpdateTopHeadPosCb|saveClearWcould
_requestMutex|groupedSpecifed
syncNameAndBloodShow|specialUnnecessary
screen2Space|scopesDestroyingFree
removeSpriteInitCb|updateWritingDetail
m_swallowTouch|m_rankedBuild
m_resReady|dereferenceCheck
addCacheSpritesPre|presentedSpecifiersWhen
m_isAutoMove|m_operationsSourcePartno
ViewSize|alternativelyWantedBehave
DefaultMapBackLayer|m_abstractionRevisited
NearTiled|itselfHoldsRequired
Direction|properlyKeywordProcesses
LuaMsgBuffer|coverageThemselvesRefers
changeMode|linkDescribedRtti
MapScale|dynamicLearnDoing
_responseMutex|leastOffer
ProtoBody|pathAlgorithmPreserve
excavateToTheDir|functionalTupleName
m_actionHide|m_wellAdvance
addRenderListCallback|understandBracket5
m_thread_quit|m_failUnableDerived
hurt_kneel_inited|m_accustomedRvalueBack
cleanOtherActor|valuesGraspStoplightEyes
removeSetVisibleScreenCb|invokesDifferentlyName
Commen_Direction|brieflyReimplement
ActorType|latestExecutesHiding
AsyncStruct|benefitSpecifyingAverage
FollowNode|correspondingTotalManage
CenterNode|memorySimplifyBlueprint5
Touch9Sprite|constexprStops
moveInTheDir|knownDeclarationsSimply
m_rocker_direction|freeTransactionWilrefer
m_restTime|m_somewhereFriendship
NameSize|eachOperatorsWhatever
m_managerInitNum|compiledRedefinition
_cellsUsed|muchExtended
loadFlyTrigger|reasonsMeddleFacedOffer
m_components|m_encapsulationSetting
initDeathStatus|chosenPscreenRealizing
setViewRect|assignedDifferenbetween
maxcut_stand|m_valuesInaccessible
onAfterDraw|bindsRegularScoping
DownloadUrl|thosmembersSequences
IsConveyAction|contentExpects
SpeedRate|reachEachElemeis
m_isLoadPlist|m_fifthUpdates
m_setWhiteCb|m_answerFrees
pszFileName|m_stringsSome
PathByPos|parametersAlways
initFlyStatus|especiallyControllingWere
_AppMsgFlagTo|exploitDuring
cczPlistFileWork|freesDifficultResult
GroupAndInGroupFromIndex|blueprintTestAddress
isDragging|argsAllowParameter
m_beginNode|m_stopLvalueSpeak
syncSendStateWithChildren|preserveArgumentobjects
playAction_ex|operationsExpectations
m_loadTextureEntryId|m_initiallyLets
m_actionOpacGap|m_linkDescribingResources
m_unAttack|m_approachIndicates
targetPoint|m_definesOperand
reloadData|convertingApplyContext
maxcut_ride_run|m_limitsFrontHowevewe
m_farLength|readComponents
DisplayMap|overDifferencesGuide
addTextureSprite1|enforcesMutuallyBuilt
maxcut_death|m_correctDestructors
_blurSampleNum|discussioofMultiple
m_sleepCondition|vicePrint
ActionWithChildrenType|tookTemplates
m_map_allAdd|m_tchangeFrameworkBase
addPhantomMoveEffect|conventionsDirectPeppers
initHurtKneelStatus|brownImplementDeal
suddenToThePos|actionRegardlessUnwinding
_successCallback|wmustBoundAproblems
m_time_label|m_allocatesThrough
m_rotateDrct|m_checksLineTime
LeftTime|consultRedefinition
m_justDelayCheck|m_allocateConceptuallyWorth
rocker_loop_max|contractRationaleDone
registerDownloadSucCb|membersModelNeeds
errorCallback|m_choiceMostProcess
m_touchType|m_directionsCheck
m_auto_clean|accessIntvalues
_deltaTimeTmp|m_passFlagged
initRideStatus|eliminatedAreaPrecise
_selfAdaption|m_unchangedWhatProgrammer
_container|m_previouslyPreserving
MsgBodyLen|nonconstUnchangedInvokes
_AstarNode|learnedExonlyRather
ActorFlag|intrinsicfifthInttyp
death_inited|privatecopyLimitedChoice
AWC_flyState|actionsInitializeby
m_allShowWithoutCheck|enclosedRedeclare
PlistsNum|lettersStrblobIsfifth
maxcut_weaponeff_10|fairlyCharacters
FlyMode|detailedSizeAvoidStudy
m_offsetPos|m_letterFamily
maxcut_fly01|m_throughoutWriteFails
maxcut_fly02|m_nontemplateTypically
m_curTargetPos|m_temptingKinds
m_resSuffix|completelyTools
registerSetOpacityCb|implicitObjecExisting
registerSuddenCb|aproblemsDifferences
SpriteGuard|istreamBookstoreExhausted
FontChina|ignoredWork
EntryId|lookTheseElsewhere
print_storage|givesCurliesPast
updateJoystick|tendUnableNamingReal
AsyncJob|mightAppeaanywhereCalls
m_footprintsGap|m_readCurrentObjectsth
resetDisplayGap|integralStoring
_asyncStructQueue|intvaluesAttempted
_addCellIfNecessary|targetDeclaringTell
cczPkmData|viableOnalthoughSubmatch3
playerAttackToPos|thoutermostCoverage
stopRocker|lookManagedWholeTurns
PositionFromIndex|enumeratorStartingPushed
syncKeyPosToDetailMap|letterPartnoCompatibility
ActionStateChange|exampleTriggerSuch
hideAllActionChild|curtokWritingEffect
groupCount|exercisesReadingBack
ShowTag|languageKnowsMatching
LuaEventExEx|predicateEspecially
Commen_ActionToDo|conversionsBeganGeneral
sendPointsByAstarPath|translateContinues
initWithFileExt|againOrdinaryEasier
ActorRenderQueueManage|thanDespiteInstantiation
m_pszFileName|m_specifiedMean
_progressCallback|differentlyVeryDisallow
popLongLong|randomTightlyIntend
checkMapIdInAllAdd|gradesToolsKnows
s_sendMsgBuffEx|m_untilNestNodefault
OnRideId|denotesCompilation
flyTriggerList|writeRecompileWrong
initCheckFlg|algorithmsWarrantRecord
Tools|intentEquivalent
removeComponent|rememberEnumerationTends
m_isActive|heldCounts
YGirdViewDataSource|guaranteedAlgorithm
registerSuddenDistance|gaveBackRolesTyhave
CacheNum|bypassSolveMatching
YScrollViewDelegate|circumstancesStream
_blurRadius|m_unlessClassesSuch
MapView|extentAspects
ActorId|unableCoverPassing1
flyToTheDir|resourcesDefineCalc
calculateAssetPath|pointersIdentification
m_fly_mode|returnsLetters
_parentScissorRect|m_transCompatibility
girdCellWillRecycle|grantsDistinguish
HandlerMap|legalTypeinfo
initAttackModeStatus|largelyNoteTheir
m_loadPlistEntryId|m_initializeEnclosingDesign
removeSetPositionCb|existingLimitDetermines
DecodeBuffer|publiclyMadeRight
MakeNumbers|consistsDoubled
pushDataByString|unchangedOtherwiseThan
attackOneTime|collectionGreatlyCreated
dir_next_tile|linkingInstantiated
NameLabel|existingClearEnable
updateShowState|modelEntireIndicates
SendMsgCount|splitRecognizing1
actiontime|m_siteDecide
VisibleCustom|restrictionsOperatorclick
m_show_plist_path|m_operatesMembers
ShowTexturePath|convertPerformRequires
ConveyState|followingKnowledgeSets
LUA_YGirdViewDelegate|comeMissing
girdCellAtIndex|wantContainerDelegates5
m_suddenTargetPos|m_parametethatGeneral
FootprintsOpen|havingReadsIdeas
createToTheDir|nonconstDecrements
TileByDir|currentlyDefiningTrying
moveMapByTouch|muchWideOffsetsExists
CenterPoint|currentExpansionRuns
AttackMode|compatibleTestStudyLittle
FatherType|integralSuspendedEnough
m_name_label|caltoAddsHandle
IsFinished|chainCompatibility
_m_touch_time|representsFunctionality
registerMoveKeyPosCb|moreCharacterAccess
systemMoveRoleToPos|thanChangesHidden
MapSpan|bracketsEqualitySpeak
ShenbingStatus|soldSelectLinking
addTextureSprite|listitemLargeAkinSets
removeSuddenDistance|includedConventions
digToTheDir|thcallRedefinesVariable
initStandStatus|behalfAdvantages2
ShortMode|translateCoverageSupports
DirByTile|machineDeleterSets
ActionState|efficientCertainSwap
checkMovePos|declareRandomDynamically
DirectionByDir|comesPromptTreated
StFPSlog|patternIndicating
OpacityCustom|externfifthTookFamily
m_showNums|m_muensureHeldEntry
repSpritUrl|stringthMark
DisplayStatus|incrementsMarker
m_noMove_cb|m_averageTable
OnRideWithChildren|stackLongtypSmaller5
m_setOpacityCb|featuresCurliesAdvantage
m_customlistener|m_defininsideAggregate
initAttackRushStatus|managedDescriptionFlags
updateOpacityAction|destructorsIntrinsicfifth
m_showMsgID|transContainsAbstract
m_speedRate|m_blobExternfifth
ShowLayer|greatlyAllowedObjects3
cczPlistFile|relatedReverseCalto
maxcut_attackmode_09|m_wefifthWithin
_cellSizeIdentical|m_againSoldBits
maxcut_attackmode_07|recentForces
maxcut_attackmode_06|m_whenStartOthers
maxcut_attackmode_05|capitalDestruction
maxcut_attackmode_04|m_coveringAddressBeginning
DirIDByDir|versusBlobArticles
maxcut_attackmode_02|whifDirection
maxcut_attackmode_01|m_delegateDevoted
TouchSprite|commonlyInspiredQuery
m_center_item|makesCompare
BloodType|directlyOrdianary
calculationArrival|powerfulReadersCorrespond
CLuaParam|hidingHides
m_downloadListenerList|wellFormDifference
runLuaFunc|standardActionsDivide
m_plist_loadnum|m_datsuchElemeisNaturally
removeMoveKeyPosCb|efficiencySpecification
s_sendMsgBuff|m_listPlaced
showNameAndBlood|studentCloseReferring
m_petOnRide|groupField
m_viewRect|separateDestroywhen
m_nameSize|againDescribing
SuddenSpeed|funtionSavedMovement
s_recvMsgBuff|m_sampleEncapsulation
MaxReadCount|guaranteedExtendedQuiza5
hurt_inited|m_developedChosen
DirByNowPoint|processDatabaseIterates
m_OutsideBodyComponents|operationPreviously
m_sudden_cb|m_togetherFundamental
_requestQueue|m_fullyEncloseConstructor
BigValue2Host|previouslyIncludesAfter
addComponent|strvecDenoteApplies
m_suddenDistanceMin|m_publiclyOtherwise
m_managerList|m_translateViolationsSets
progressCallback|m_commonCabe
AttackModeC|browsersDeclarationOpen
doOpacityAction|careRepresentedMarker
m_auto_clean_cache|partViable
insertActionChild|recompileBookstoreValid
m_setLocalZOrderCb|m_guaranteedEnding
girdCellHighlight|yieldDevotedConstruct1
m_random_mode|staticsDeclaration
maxcut_hurt|valueAssignmenclickLook
sendSocket|printedSurprisingCurly
_errorCallback|basicProgrammingAbout
md5_finish|thoutermostIsbnsLogical
magic_inited|m_enumsEasier
m_shenbingStatus|behaveConverts
convertMapPos2EdagePos|botherExplainsSubset
md5_update|colorHidesConstitutes
m_componentsAttrs|m_orderSubset
AppMsgHead|positionally
m_start_point|closeAbstract
isactor_flag|m_identicalSimilarly
playActionWithChildren|includedCharactershaving
m_isFixAnimDir|m_toolsChanged
auto_download|studyMembers
maxcut_magic|m_fixedSeparatedOriginal
m_isAstar2Finished|withSelects
m_suddenSpeed|m_areaDatabase
m_show_texture_path|positionEssentially
PageIndex|needAppeaanywhereHelp
registerTouchMoveCb|movingClassesLocal
removeSetWhiteCb|largelyHoweveweHereFamily
m_conveyState|m_makeAssignmentExceptions
addTopHeadNodeToMap|nodefaultGoodIsbns
m_is_right|m_inherentlyInstantiated
m_setWhiteComponents|m_needingStarting
LuaBuffer|enumsInitializations
girdCellUnhighlight|duringLeadsConstant4
m_updateTopHeadPosCb|m_requiresDocumentation
m_onRide_id|m_extensioindicatingSpecify
m_followNode|m_despiteDenotes
shadow_sprite|initializebyDefinition
asyncEntryIdCallBack|imagefifthOrdianary5
m_touch_move_cb|variablesNontemplate
m_isInRenderList|m_tightlyRepresentsPasses
ConnectNormal|caltoStoplightDesigns4
_m_move_time|m_invokesTimalthoughNewline
registerResetDisplayCb|striparameterCompiledLets
openSocket|unlikelyWordApply
ShowBloodAnim|bookstoreAutomaticSection
m_pszFileNameList|m_familiarPrevent
_cellsInGroup|aboutSeenDirect
_objRender|argumentobjectsLess
BtnContainer|doesUsableWill
PageByIndex|exclusiveWritingAend
findTriggerByPoint|knowledgeReplacesGive
m_gotoDeathCd|thatheyPointerlike
m_checkOpacityMoveDistance|m_linkageInsideCopy
_indexFromOffsetInGroup|synonymDeducesSubsequent
syncFlyStateWithChildren|identifiesResolves
_asyncRefCount|derivedSubsequent
_updateCellPositions|basicRandomWhif5
playAction|copiesRelativeReverse
removeTouchMoveCb|showNonnestedNeither
updateZOrder|versionsThoughtFinding5
cleanDenpendFrames|studentLoopAppear
maxcut_hurt_kneel|occurrenceElemSeemingly
maxcut_weaponeff_12|m_writeReflect
hurtIdleToPos|quizBecomesSection
AutoInfo|facedDefinitionsTransform
registerNoMoveCb|readersTableSale
AWC_flyMode|reduceEnumsAssignmenclick
m_actiontime|viewBecomeExternfifth
LabelChild|nonmemberElsewhereNesting
initHurtStatus|theareYieldChaptersReduce
initHurtIdleStatus|instantionRequirements
initGLProgram|flowsTargetTools
_touchPoint|nonconstComesEarlier
addWeaponEffect|incrementElements2
stopMainSpriteAction|lineIntroducedPresumably
registerFlyCb|carsNumberedFail5
createEffect|specifiesFreedRemaining
m_isBloodVisible|notedConversionImplicit
MsgID|prefixedSmaller
m_boSkillEffect|offerOnbits
AsyncPvrPath|symbolsCollectionView
AWC_conveyState|omittingTchangeTokens
m_actionOpa_state|applicationBestFile
LabelNodeC|temporaryTogether
OutLineColor|wantedChapterResources
m_title_label|m_requiresFactorialClear
removeFootprintsCb|orientedConstitutesKids
roleMoveOnMapByPos|wstringParametethHair
MoveDirectionUpdate|consistentReasonRefer
IsRepMode|singleIncludesBound
is_getData|m_substringSemicolon
unbindPlistAsync|indirectEndsAuthorsTrans5
MOVE_CHECK_GAP|m_movementLinkage
girdCellSizeForIndex|releaseOccasionallyRelies
initWithViewSize|bitsethePackStunningly
scroll2Pos|variableOriginalSmatch
LuaEventEx|behaviorDirections
registerSetVisibleScreenCb|flagsEnumerations
RestoreFirstFrame|specifiesPackHigh1
addColorGray|nestSeparatelyIterates
GraySprite|pointersCovers
screen2Tile|addsHiddenCoupled
DirByNewPoint|flipsReallocatesStop
PlistPath|targetBypassTechniques
m_footprintsCb|labelsUndefined
ThreadLogFunc|personSimplifyTook
viewSizeSelfAdaption|machineArrowBitset
m_downsuc_cb|m_equalExonlyDestruction
_plistInfoMutex|m_settingDirectly
