attack_rush_inited|differentlyRoomNone
m_ensuresUnlikeDecrements3|kindsBasis
whyouGaveInstantiate|convenientChaptersMajor
ActionTag|increasedWill
treatUpdatesPuts|friendshipfifthPreceded
ByteBuffer|introducedGuaranteed
m_setVisibleScreenCb|ideaConfusion
triggerPoint|m_turnsReference
maxcut_weaponeff_02|m_printedExtended
maxcut_weaponeff_03|latestSpecifed
maxcut_weaponeff_01|m_symbolsQuery
maxcut_weaponeff_06|m_concludesRequested
maxcut_weaponeff_07|m_exceptionSequencesLets
maxcut_weaponeff_04|specializationsProgrammer
maxcut_weaponeff_05|fallWhifDesigned
sCapitalAddition|pushedBoundthatEvaluates
maxcut_weaponeff_08|m_constraintsCopiedStrategy
maxcut_weaponeff_09|chainLooth
md5_process|relevantComputeIllustrate
removeRenderCallBack|forcesCopiesPass
TouchEnabled|whifEssentialSees
m_fairlyUndefinedparameters|readingChose
ProtocolPacker|spaceMust
illustrateRoomDesigning|stillBraceAddition
m_encapsulationHaveDepends|m_comeProperIstream
m_recordIndependently|m_seeminglyNinesUnscoped
registerSetWhiteCb|blockHashCentralThreed
m_ActorComponents|m_reallyWhis
resetSpriteAct|queryresultCompanion
inGroupCount|discussioofUnrelated
stand_inited|m_withBasics
createChain|supplyingEnoughConfusion
intvaluesenumCommonly|addsReallocatesLimited
m_sharedCoutHappen|pointedImportance
m_featureBookThrows|m_numbersParentheses
m_syncPosMoveDistance|m_numbersFull
m_pointGeneratedHair|m_conventionTransactio
m_unselect_action|periodDirectionsNormally
m_async_pvr_path|constexprReachDistinctive
TitleLabel|directionCccccccccc
moreFilesValuelike|toldThdefinesClassesclick
guaranteeBlobptrDefined|operatingBoundthat
m_renderList|m_thatheyDefaultsAliases
canShowNormal|evaluatedTypicallySample
m_automaticIdeasProgram|supposeparateRevisited
saidReferencesWhole|generatingMovementLink
autoPathFlyTargetPos|m_toolsFull
goesDereferenceReaders|hasptrBooknoInitializthe
LuaBuffer|encloseFunctionalMany4
knownRationaleStudent|limitDeleterTries
holdsPrecedeStatics|peppersMeddleEfficient1
AsyncDownloadState|vectorsWithfifthPublicly
copyMainRole|exampleTextqueryAlgorithm
includeQuestionReverses|techniqueFunctional
m_mapScale|m_fundamentalCursor
m_argumentAccessed|m_istreamImagefifthReduce
initDataAndFunc|storingRemovedRedefines
bitsetheWstringDesigner|doethPageNearly
scrollViewDidZoom|qualifyingLimitation
efficiencySensibleGrasp|enumeratorsFigureDevoted
m_manyPermittedOperands|m_presenceDoethChosen
numberOfCellsInGroup|othersDebuggingAcross
occurDifference|treatTriesAproblemsBuilt
SkillCtrl|coverLabels
m_peppersChartypSymbols|m_swapGrantsPartially
WhiteCb|exploitForgotGoes
ShowHeight|precedesSpecializesTerms
m_isOpacAction|labelsDatabase
m_includingProblemEnclosing|m_wilreferFreind
visibleDefinitionsTokens|relationshipUntil
m_wmustOwhichCalculated|m_ceasesExistingLooking
removeResetDisplayCb|variadicResolution
m_restoreFirstFrame|m_owhichGeneral
changeStateWithChildren|numbersIndependent5
boundthatProhibit|comeRealDecrement4
m_copyReturningOpposed3|m_lettingFlowsIntent
chapterLargerReturns|intoPresumablyCandidate
m_playActionWithChildrenCb|m_actualNecessaryRemaining
holdIncludedInteraction|ideasSketchFullKnown
PlistNum|referencwhatTchangeEnums
m_instantiateDefinitions|syntaxDescribe
matchesOperationsHowevewe|implementsArgument
soldInformControl3|assumingExample
includingPatternsBrowsers|normallyReduceCopying
PageByIndex|whatExpandRecognize
m_aliasesTemporarySimilarly|m_relevantInstancesUntil
m_fairlyConvertsExact|m_toldOriginalSales
operandVariableUnderlying|classesPromotedExonly1
calculatedSpecified|inherentlyQuite
stringthStreamForget|goesIndeedNested
hideJoystick|abstractAuthorNone3
SpriteBase|groupedEach
characterExpectsCoupled|operateConvenientExplains
m_authorsIdenticalNonmember4|m_previousChangeLeft
hierarchyFollowOtherwise|takingGenericCtype
constitutesUpdates|grantsDescribingOperating
attackToPos|reversesIncludesReside
m_showBloodAnim|withTurns
FontChina|behavesExpanded
m_addsParametersIndexed|groupModelIsbn
versionStaticsCallpass|nonpointerExpandFollowed
TouchEnable|executionCurrently
removeSetVisibleCb|sensibleExplainingAssumes
qualifyIteratesDeduce|soonUniqueExhasuting
m_assignmentMimicIobj|m_indicesSynthesizes
WeaponEffectPath|stoplightResultsContract
triggerExampleObvious|indicateContaining4
tingWhisAbility|instantiationsCompatible
m_operatorclickReferring|separatelyMatterVerifies
ordianaryOccurrenceAround|prohibitComeCorrespond
m_equalsTopicSoonExists|intrinsicfifthConflict
m_openActionCheck|termsDebuggingProcesses
alongChartypForm|destroyingIncrementsWmust5
illustratedLeastComputing|expandedIndeedDerivation
thcallRegardless|problemsMemberAppears
limitedTookAffectsField|variabandCalculates
usefulObjectExchange|separatesExclusive
tediousLeavingCharacter|programsCalculate
pointersFurtherCompletely|illustrateInstanceAlong
iteratorArticlesPresented|tpreviousPeppersConstexpr
referredStringsRepresents3|advancedConsistsIntvalues
m_basicsPairPreceded|m_conswhatEscape
hurt_inited_idle|m_suppressEnforceFramework
shorttypEncapsulate|severalTimalthoughShared
currentlyExceptionIstream|queryresultGrants
m_instance|recognizingOrganize
particularDerivedCallable2|aliasesAvailableAnswer
m_heldInitializations|m_charbitsInteresting
loadPlistAsync|yourObjectsthEntire
m_preservingCodeSafe|ultimateThumbPass
rankedInteractionEllipsis|tellsCompletesUseful
encapsulatesIntend|ownsIndicateFreeSkip
matrixCouldActually|thgeneratesSupplied
registerSetOpacityCb|performTermsVectors
referHasptrInspired|backslashAnotherOften
SelectAction|especiallyOstringstream1
thosmembersPageTypes|aproblemsRestrictions2
m_illegalBuildVaries4|m_decideUsableSpecializes
m_center_node|identifiesInitializeby
downloadFinish|differenbetweenSystems
SpriteNpc|stringthInform
VisibleScreen|enableRewritesPrograms
m_roledata|transactionsEveryCursor
mistakeAssumedFreed|mutuallyFullLooks2
m_auxiliaryGenericSimilarly|tchangeComponents
m_recentRecord|harderPatternsSensible
hereNontemplateWestore|secondLargestInitially
m_elsewhereBetterFacilities|m_builtUsesCars
FlyMode|mistakeDoingTogether
m_varyingEncloseEamightAdds|m_advantageHideLargely
m_aboutClauseFactorial3|m_iteratorsLimited
m_checkResType|followedDeduction
multidimensional|factWithoutLocalLets
m_sprite_init|m_articlesChanges
m_speedPercent|tellsConnectionPrefer
m_footprintsGap|findsReferLooth
cleanPathByFly|nontypeMemberwiseWrote1
initializingAppropriate|followingAgainTransform
wregexLabeledReach|comesEntryInefficient
m_showMsgID|m_accustomedMoreHash
beganEncountersDetermined|specificationCompletes
ComponentByTypeAndId|printsWmustSketchWhen
AttackModeC|respectiveHeaderElemtype1
thatEmptyIterator|becauseDefinesDesign
FootprintsGap|linkingCharacters3
suitedBrownOffsets|writingMakeAlegal
StandTime|inherentlyAlwaysCalculate
m_meansIllustrateExcept|m_unscopedOccurs
blueprintRelationship|argsIndicatesUnderStop
positionsExpression2|argumentsExpects
beginningVerifiesShaking|extendEquivalentthPostfix
duringSeriesExpand|lettersHeldPrecede
statementDeduceCompiling|characterIndicate
walk_inited|memberSuccessful
transDeletesCerrLeast|thoutermostAlternatively
somewhatLikeFlag|entireRefersSupport
MapOperate|relevantReviseReason
m_theirDownCorresponding|naturallyTokensSwap
m_indexingTimalthough|m_reliesCharacterSafe
m_cellImageSuffix|revisedValidBetween
m_isLoadFinished|m_includeInterchangeably
indexingPairDescribe|implementClauseSecond
downAccessible|multiplyingExhausted
doesWithNonpublic|storageVerifyLimitation
aliasAssignsRepresents|associativeBits
operatesSchemaClasses|accessResourcesAvailable
comesProcessingPartial4|programmingProvided
removeActor|striparameterDeclared
majorLongtypBest|valuesChaptersElements
equallyAcrossCurrently|skimPeopleDenoting4
treatVisibleOarguments|intendIndeed
m_independentlyActionLearn|illegalContains
whichMemoryGroup|viableShareProperties
differWereIcaseStop|computeMissingTimalthough
preserveEasierDecrements|textEscapePrefix
m_streamDifferently2|m_neededViableInteracts
expandsHeaderBoundNature|partialLetterWefifth
m_blockStr|m_parameterException
colorFlagInitializes|discussionAuxiliary
expandCopiedLanguage|designerMinimalTable
flyInitPos|instanceProblemMatched
destroywhenColonWhere|interchangeablyParametis
m_theifPredictedIsbns|m_shownIncrementally
changedSyntaxCopy|acrossInttypStops
correctlyEmplaceConstruct|wherebyFlaggedDiscussion
convertedDependsControls|endsDoubledNoteFaced
passesWriteColon1|tendsSwapSaid
AttackNum|numberedSolveTemporaries
decrementsCallpass|ownsOpposedIgnored
UnSelectAction|treeAlternativelyMatters
checkPlayDefaultAction|turnsAddingPublicly
speakVicePreserving|executesTargetLine
m_syncActionCb|m_readOrdianary
problemsGreaterDatsuch|expectationsIndicates
highestSureTable|vectorSolveGreatly
_entrySeed|m_tookArgumentobjects
AWC_attackMode|definingPartnoUnequal
removeSpriteInitCb|exclusiveTextHeader
wefifthBindSmart|additionalCompareisbn
removeColorGray|bookstoreEvenElemeis
abstractUninitialized|tookAlongConversions
m_befriendConventionWhereby|m_combineOperations
speakCardOwns|separationSafeGets1
ActorActionManageC|resourcesBook
codePeppersIncluded|comesGroupedBeginning
logicalFlowsExpressions|variousSupposeparateLock
m_violatePositionsCompares|m_partialFacilities
DefaultMapView|m_visibleEamightRelying
FlyModeValue|overrideUpdatesConvenient
indeedOverloadUnnecessary|boundStringsGenerate
checkMainRoleTile|failsViewFunctionality
passesCerrWhenever|providesPointsunlike
becomePredictPerform|theyOrientedDeleted
m_base_cache|brownDetailed
checkMapIdInAllAdd|initializersValueduring
ShowTag|runsLabelsStore
embodiesPermitted|toolsExpressionOthers
removeCellAtIndex|onlyDifferingMemberwise
onSubThreadLoop|sometimesNoneCalling
AWC_stopInTheTime|verifyHandleContainers
m_namespacesReadySave|m_validNocopyBehavior
privatecopyMakingDiffers|appearUsedIndexed
removeMoveKeyPosCb|runningExtendedPair
shorttypCopiesSale|thirdOuterUsersRelevant
resolvesBlobptrEvaluated|defineLatestNonnested
BigValue2Host|doneMightBoundthat
CurrActionState|processingEamightSelect
passesEasyWritten|expressionasExercises
specifiesIllustrated5|chosenPreprocessor4
m_cacallSomewhereFacilities|supportedDifferenbetween
resolvesNonstaticPrefix|supportsCountsAlegal
buildsDecrementCreated|conversionchapter
nodtorViolationsWrite|specializingFriends
accessedFriendshipfifth|wstringHereSpecifier
YGirdViewDelegate|intendedSynthesize
computationalFurther|somethingEspeciallyEnable3
m_blood_bg|synthesizedEncounters
precededBlobptrGranting|heldSuppliedOperation
contaianyHelpfulFeature|hasptrWaysTransactioPage5
_touchLength|extentEmplace
knowledgePointersFifth|sharedPrimaryLock
m_destroyingLockEnforce|m_imageAvailableTreats
m_inevitablyBeganPrevented4|m_howeveweStop
SingleVisible|findsDistinctPresented
noteUlongStrvec|explainingToolsMemberRtti
MapRecvByte|declarationsDisallow
resourceMakesBehave|alreadyDigitsCccccccccc
m_actionsAttemptedCompletes|sampleStarts
maxcut_attack|boundthatType
comparedSavedIntroductory|containsMarker
addCacheSprites|usuallyReliesAsked
md5_context|grantingUsesArrow
autoMoveShow|properLibraries2
m_load_all|morePermitted
scopingViewDetailsPrefer4|indicatingWrite
specifiedWantsResulting|referenparameterIntend
m_cache_anim_List|m_recompilingWordCompared
removeRockerCb|findbookRolesUnrelated3
thoutermostLimitNumbers|rewriteCandidateDefining
createBecomeBeyond|expandingFunctiocontrol
m_setVisibleCb|definitionOstreamDiffer
backLookAbout|buildSynthesizesBitsets
LuaSocket|filesSignature
m_curTargetPos_tile|m_primaryComputational
m_strictlyExternfifth|m_commonMachine
IsOpacAction|arraytheRelated
wordSubmatchDisadvantages|signatureExercisesPrvoid
m_blood_pro|m_thanGradingBound
longtypBrownEnds|manipulateChainRealizing
m_aspectsTurnsExplain|icaseTightlyWhole
dynamicLengthSomewhat|multipleChainIndexThan
DefaultMapBackLayer|whsuggestYield
identifyLargerPdata|wholeGuideBodiesFuntion
removeSetLocalZOrderCb|treatedCoverFixed
excavateToTheDir|specializedDetailsActs
m_specialViolatePrintedHair|nextFunctions
flagsWholeInclude|aheadSureQualify
addRenderListCallback|implementDestroying
succeedsTchangeDeduction1|nestedCorrectChanging
m_allShowWithoutCheck|literalLinkMajor
leavePushNocopy|simpleHidingRoles
wrongProgrammersBookno|separationCompilerEntire
moveInTheDir|omittedLengthConvert
exclusivePreprocessor|improvementsRecognize
magicUpToPos|conversionchapterKnow
_cellsUsed|powerfulCalculate
_indexFromOffsetInGroup|endsLetsProvided
fithatDifference|librariesAlmostOverride
thatheySafelyCtype|becauseImplements5
ManagerByState|overloadedAspects
m_symbolsRepresentOperand|m_exceptionsPuts
DownloadUrl|queryDoethModifySyntactic
underBookAkin|violationsFlagEcmascript
predicateIllustrate|interestingCallApplies
_AppMsgFlagTo|letterEamight
removeTouchMoveCb|lettersOnlyLookFuntion
programmingDeletes|hardFundamentalAlmost
m_loadTextureEntryId|m_exceptKinds
m_actionOpacGap|m_nonstaticLiteral
limitHardestZero|deductionAllowsHeld
m_imageFifthDeduction|m_encapsulationColorTaking
reloadData|viceSpecialSpecified
m_accessedCallingGuaranteed|operationFixed
m_farLength|smatchBecause
m_specificThoseBlobptr|m_helpfulAendEnclosed
spellingEyesWhsuggest|implicitlySomeUsers
confidentNodefault|stringAboveReaders
m_inheritancePointers|m_interestingPageGuide
prefiMultipleEnumerations|reusedCoupledCare
confidentInstanceEmpty|usersAddsEasier
compilingDetermine|abstractionMany
evaluateReplacementDown|wholeContentsKind
prefiModernKids|alongThusProcesses
functionalAngleElsewhere2|pointsunlikeExhasuting
isfifthDistinguish|decrementsCorresponds
m_interchangeablyTopic|m_formSpecifyingTypes
m_flipsWidthForces|beginningNodefault
familyAlreadyThosmembers|specifiedCacallExcept
death_inited|m_contadeclarationsGood
istreamTypcanCovered|ecmascriptWhetherControl
m_offsetPos|m_writeRemainsSelected
maxcut_fly01|m_exampleSimply
maxcut_fly02|m_reflectIndexedCallable
maxcut_fly03|m_regardlessExpectsObjects
listitemSpaceEliminated|aliasExerciseHeader
whisRelationalEvaluating4|needingIncludeEntire
registerSuddenCb|specifedAlternatively
wordDeducesActions|seesPrintedRepresented
triesOptionsIand|operandPartiallyTheir
aliasesDealingCompanion|operandFromExpressionas4
m_toldUsersVery|preprocessorJumping
m_solutionExplains|supportsStrings
m_declaresAvailableResolves|m_labeledTyhave
syncKeyPosToDetailMap|resourceAllocation
ConveyState|techniquesOverloadBased
m_storagePackStatement|m_transformationPrints
generateUnnecessary|almostOverCalls
m_cacallConsultSynonym|certainVector
resourceUnlessTook|resolvedEnableSeparates
numericChainCorrectly|prvoidAcrossGranting
partiallyBooksDetail|contextNotifyStrings
tchangeLimitsAspects|somePartsWereInfer
giveWordRequested|patternFeatureRegardless
managingCoverageWhenever3|undefinedUpdateStarting
compareisbnBook|variablesInttypesNontype
recentYieldCurlyFact|applicationsAverageAend
verySeparatesDestroying|allocatesParametersunlike4
flagsScopeVariable|consultUnablePepperby
indeedPromotesFacedCommon|elipsisThatRule
m_importantMarkSets|indicatedPriceLogically
illustratedAnalogously|bestJustRegardless
m_convertibleInstancesKnown|callsPage
letterIndicatingProvided|expressionsOrganize
_parentScissorRect|imagefifthDeal
pushVerifiesImageMultiple|subsequentDenoteLibrary
accessedLoopsPrompt|userLongerPrevious
HandlerMap|fonumberRespectiveSuited
m_signatureSucceedsLeft|m_translateRatherEvaluating
isDragging|nontemplatePointersFrees
m_iteratesAccessNamesLabels|preventedTends
markDiskRedeclares|contentStudyRewrite
AttackMode|equalityFailHiding
m_auto_clean|implementingIndeed
m_propagatesArgumentsUpdate|equallySolveLatest
m_debuggingEndingPrecede1|m_stringthAbsolute
m_okayDataDriven|workArguments
elemHandledAllocation|arraysArgumentOriginal3
detailedWordFactorial|worthSystemsAvoid
LUA_YGirdViewDelegate|complexityIllustrate
needsDescriptionOmitted|representUnnecessarySaved
m_suddenTargetPos|m_inefficientFollows
conswhatLegalSample1|fewerDescriptionRemain
omitProperEffect5|includesMachinesVaryCause3
TileByDir|deletedChaptersThrows
m_touch_enable|m_expressionasStop
computationalConstructor|improvementsRatherThen
m_stillSeparateIntuitive|throwsKnowledge
hasVisibleParents|dimensionAlmostSystems
_m_touch_time|m_capitalDirection
systemMoveRoleToPos|naturallyWrongVersus
DisplayStatus|loothUnnecessary
discussioofComesWstring|authorDesigningIdentifies
addTextureSprite|forgetExistingProcesses5
m_representsRecordShows|m_defininsideGood
digToTheDir|usersAttemptedDecrements
m_constsBackslashViolations|m_selectedShakingCapital
DirByTile|determineInvolveConswhat
m_OutsideBodyComponents|m_importanceDereferences
muensureIntegralPair|hiddenRegardless
_responseQueue|m_andqueryComparing
m_discussionTurnsExploit1|m_takingOperationDeclared
m_downBeginningDespite|encountersDrivenShow
introducePlacedSucceeds|inherentlyRealizeCoverage
fileSomewhatConsis1|thoutermostMuchBinding
matchedInaccessible1|collectionsCentralTheir
m_freindCorresponds|loopsIand
salesCollection|managedIndicatesIndicate
m_rttiFollowBrace|lookingConversion
m_customlistener|definesTokensEyes
doubledWilreferCeases|updatesAuthorsLooth
noteOperationsBypass4|preferredMovingAppear3
m_includingDiffering|m_patternsIncluded
whichPreserveMatters|sectionsInaccessible
DirIDByDir|handleStringthSubsequent
handleDetailedShown|comparingTprevious
topicBrieflyAlways|applicationTellsForgot
m_iathInitializesRelated|pairwiseLimitation
tellsPdataBrackets|quizAppearIndeed
m_hairStrvecSupplying|bracePreceding
m_referredDescription|m_zeroInitializersTells
s_sendMsgBuff|m_timeAdvancedCause
anotherIndicating|identifiesNormal
ClipboardHelper|offsetsCtype
wstringUsersCombine|systemsExpectNest
_objAttrs|illustrationDestroyed
m_thexercisesFacedAproblems|m_tookControllingOnbits
promptHardestStartsWhyou|precededQueryObtain
NameSize|doubleprecEnumerations4
periodDenotingCurlies|changeUlong3
likelyGeneratingNormally|unorderedExecutable
mimicElemNamed|meansPutsBehaves4
m_settingNothingCalculate|basicArgumentobjectsShare
withinLibraryLists|simplyNeverOutside
AWC_setActionStateChange|delegateMattersWellUsable
m_auto_clean_cache|m_grammarTheif
spellingRequirement|incompleteIgnoredLibrary1
m_showNums|m_equalBoundthatCout
m_selectedFunctiwith|m_considerUnable
convertMapPos2EdagePos|indicateTypcanGrading
AppMsgHead|knowledgeConversions
m_elipsisChecksInside3|ownsTypeidsFunctionality
m_start_point|m_actuasizeSystems
flagRemovedImmediately|doesPointerAngle
playActionWithChildren|membersExpansionMistake
relyingTheifNonnested|thingEssentialBoundKnow
assumeLocalActuasize|delegatesFocusSupplying
beginningAffectOarguments|separatorAboutDesigners4
turnAddingCoupled|deductionPriorSuobjects
anotherAccustomedPoints|throughoutCompiledLittle3
variesPredicateAttempted4|enclosingDistinctGave
m_treatsApproachInstantion|m_alegalExplainRecursion
staticsFonumber4|charactershaving
girdCellUnhighlight|functiwithPowerful5
_loadingThread|soonFragment
supposeparateUnordered|imageOughtOmittingObjects
operatorsMuensureIndicate|salesContainsAggregate
SendBufLen|parametethatNearly
m_executePositionedInform|messageEnumeratorFeatures
attentionDeletedMembers|oargumentsSynthesized5
registerResetDisplayCb|positionallyMovesBooks
openSocket|spellingEitherSignals
answerDealTheir|thumbDerivedAlways
relyingArraytheExecutes|computingOwhich5
messageViewUsable2|referenparameterAdded3
operateWhicheverResources|documentationSelected
otherwiseReferencwhat|suspendedDevelopedColor
namingIntroduceIncrements|synthesizeMightSwap
passIllegalBriefly|askedCannotViceEarlier
supportWereChaptersJava|permittedThreedPlain
FlyModeWithChildren|bookstoreIncidental
updateZOrder|lastDevelopedChparameter
m_markDebugdeleteResults|m_requestedSaysImagefifth
checksStartsNeeds|constitutesMatchesVice
AutoInfo|attemptPreserving
registerNoMoveCb|theareNonexistentMacro
AWC_flyMode|charactershavingSemicolon
InitMsgBuff|knowsClassesWhat3
defaultsCcccccccccActs|yieldsWstringSkip
assumedCouldUsable|accessibleOccasionally
stopMainSpriteAction|evaluatingUltimateArgs5
registerFlyCb|emptyAddingIsbnsExpanded
m_relySupportedMoves|m_needsCleansBody
m_actionOpa_state|guaranteedNonpointer
m_reflectInstancesPairwise|m_localEnding
m_needSyncPosToServer|m_thoughConventionCompiler
wantAccessLifetime|currentlyRecent
scroll2Pos|denotesMeaning
initializationReflect|questionScopes
rolesPackSingleHeight|lifetimeTransformation
m_theirFollowPropagates|m_alsoDerived
screen2Tile|reasonsHeldEfficient3
showJoystick|regardlessThose
FrameEvents|iandArticles
viewSizeSelfAdaption|splitLikeGreatlyComplex
explainingOmitted|testIostreamProperties
includedLeastClassesclick|inefficientAbsolute
m_downsuc_cb|resourcesDeclarations
ActionName|splitRulesWork
checkFlyAutoPathTarget|whifArrowUnlikely5
recognizeTemptingThey|existCommonExpectations3
rewritesIsbnsThere|bestRuleInttyp
coveringEfficiencyOften|definedLettersNeither
needsFieldIntegralFrom|generalDatabaseGiven
effectivelyCoupled|mistakeRepresentsNeeds
smallerCountsNonpointer|addsGroupConstraints
m_exonlyAccumulateIndexed|m_helpConvert
onRoleMoveFinish|establishesCopying
lineConvertibleWhis4|purposesStringthCalculate
performedAnimatedScroll|ignoredCorresponds
m_functiocontrolDeduced|followedSafelyVary
IsLoadFinished|objectsSectionsFithat
m_funtionBaseCondition2|conversionReside
lookingMightGave|knowledgePreprocessorFall
m_orientedPreferred|m_instanceRecentCopied
stopInTheTime|ignoredPriorCaller
nonreferenceCacall|rememberSafelyPrecede
dependsSpaceValue1|omitLabeledEnding
m_inaccessibleVersionCard|tellsRelyWide
thoseChartypThing|somethingClasses
registerSyncChildActionCb|runtimeSpecificRequired
_FlyTriggers|fallDecrements
registerSetActorVisibleCd|saidPassImplements
m_ischecking|m_behaveExecutedInsert
retainMainRole|presenceConfusionGeneric
m_stayOfferArray|sampleViolateOmitted
m_visibleState|m_generallyUnnamedGroup
lettingImageFully|determinesTypically
givenCopiesFixed|wregexLargerWide4
authorsHashSerial4|conversionsIdentifyLittle
m_regularPredicateDeclares|m_doubledNonextern
BlurSampleNum|advancedUsableWstring
m_enableConstantFile|reportGenerally
m_hidesAlgorithmRelyPersist|strblobFlip
instantiateNextHowevewe|streamSettingCome
exonlyConvenientControl|itselfRepresentCare
overheadLoopsTends|employeeQualifyingAdded
m_primaryLoothExpressionas|regularMakes
IndexFromPoint|beenObviousIndices
stringthDestructors|partThgeneratesEnclosing
maxcut_attackmode_06|m_encapsulationAnother
m_zOrderFlag|leaveMeaning
roomJumpingSpecialization|differingDoubledAdvantage
m_separatorWideExpectations|markLink
AsyncFileOp|unchangedIntroduced
overallTransformRight|determinedLanguageNumber
checkMapCellIsDownloaded|evaluatesTreturnDeal
pushLongLong|otherwiseRunningUseful3
fly_inited|m_beyondActs
studyCursorReimplement|exercisesStartingCurtok5
mainGetsLikeViable|jumpingRecognizeHarder
changingGivesLeft|heldMoveIterators
IsConveyAction|akinEverythingMain
OpenActionCheck|leastConversionsMube3
nonconstMadeIllustrate|elemtypeMenuAuxiliary
instanceOverheadType|accessibleSystems
initHurtKneelStatus|restrictedComparing
hurtKneelToPos|simpleDetailsCompanion
bracketSignature4|resetWhatStoplightTheare
emptyOccurrenceSpecifier|allowsRoomParametea
separationThemselves1|bitwiseStringstheWhis5
triesEnumeratorsLikely|infrequentlyCopiesSyntax5
beginAutoAct|thdefinesAbstractly
versusSurelyLinking|bestHierarchyExhausted
maxcut_run|m_randomRequire
deallocatingTypeOffer|suitedAliasesRepresented
behaviorReimplement|schemaAccustomedTedious
systemSurelySupplying|madeErrorConswhat
m_functiwithEasier|doesndifferLongtyp
findsCircumstances|endsCorrespondPast
endsFunctionalLabeled|bitwiseGenerallyIncluding
testTheareNonpublic|ccccccccccImageth3
magic_inited|actuasizeReasonsPrevented
predictReleaseLearned|largestDescribeWrote
m_constructorButtonDefining|m_overTextqueryRestricted
friendshipOwnsCalculates|hidesExecutedEssentially
techniquesReferencwhat|supportsBegunDeduce
hasBlockPos|meanCompareisbnRecent
m_bodiesTimesAssigned|m_quizBuildsInto
beforeDraw|usuallyEncapsulated
addAutoRemoveAction|supplyingModelExecutable
loadPlistAsyncCallBack|hasptrLinkageDereferences
unbindPlistAsyncWithEntryId|recordThenExceptions
intvaluesenumPrecedesUser|executingEnforceOperation
registerFootprintsCb|leaveLogicalClasses
_vCellsPositions|m_tightlyRestAcross
progressCallback|programInitializerBegin
BaseAnchorPoint|surprisinglyHigherDenotes
CurrectDir|specialReversesTechniques
constituentSomeInitialize|eliminatedAllocateAdvance
MainRole|processingActualOperation
replacesKnewVery|priorEntryDesignersCease
notedFollowingOriginal|worryAlegalFunctions
_scrollDistance|m_expandAuthorRuns
hurt_inited|m_friendshipfifthBlobptr
resetPosByHead|theareExpansionReally4
constantUpdatesContain|thosmembersIdeaLine
onBeforeDraw|shakingNotingPrior
coupledWidthBackslash|cerrUsableLimit
m_showLayers|serialThose
m_SocketState|m_occurCompiled
argumepassedMovesNothing|lookRunsPosition
predictSuppliedLengthPack|forestallUltimatePass
m_collideBefriendExit|m_begunDealingSpecial
changesWorthSemicolon|defineInitializthePassed
m_attack_mode|extensioindicatingProvide
wefifthIstreamAdded|transformationStrategy
facilitiesMultipleBuilt|performRecompileOmits
despitePossible3|persistInstantiated5
attack_inited|multiplyingSequenceTable
thoutermostLabeledPushed|swappedItemReturningAlias
m_isbnOwnsEverything|m_findNothing
beforeIdenticalHigh|constructingPairwise
_updateContentSize|isbnShouldAddsFeature2
placeExercisesAdaptors|storeAbsoluteRelease
assumedExplainProtection|viceCopyMark
m_determineThesePrimer|nodtorCompilation
representation|comeExactlyDefinitions
calculateOffset|possibleConstraintsBeing
arrayCheckIdentical|requirementDelegate
m_groupedConsistsReflect4|m_typicallyChapterIterates
fromWcouldMean|containingOverheadRelease
m_doubledReasonIncidental|calculateImpactDefinition
inheritanceHandleTypcan|interestingBodiesChosen
_requestMutex|complicatedUnduly
numberOfCellsInGirdView|entryCandidateIndicating
YScrollView|partBuiltNumeric
role_main_id|m_partialInstance
m_rocker_dir|m_stillForwardingAvoid
m_semicolonCompound|m_coverProgrammingReset
nonpublicChapterIndex|confusionDisallowAuthors
whateverPersistOccur1|greatlyParameteaHard
rocker_loop|m_correspondsVectors
Effects|sequenceDestroy
BlurRadius|argumepassedShouldTyhave
applicationsAssignment|familiarDiscussionShould
SideTilePos|parametersunlikePasses
registerUpdateTopHeadPosCb|bindingAheadTechnique
tendsVaryResolution|focusTransactionName
consultDefiningIntroduce|doingVerifiesExecutable
removePlayActionWithChildrenCb|iteratorBeginsReview
studentCursorAdditional|matchComputeRules
registerTouchUpHandler|matchesDeletesPushBlock4
strvecMatchingSafely|movementCharacterExpects
m_tookMustIndicating|m_intentViolationsNext
m_availableFuntion4|m_identicalIdentical
foundUnchangedEveryAcross|indicatedIndependent
tchangeWhifTells|onalthoughWaysCorrectness1
relevantNonstatic|promptReviewExploit
companionEarlierOver|secondExistingTransform
m_functionalitySecondHeight|m_storedVariables
initializersWhappears|worryBeganLeaving
eitherAndqueryTopics|toldSpecificAssumed
m_updateTopHeadPosCb|m_reviseContents
m_heldEvaluatingManager|m_surprisinglyThoutermost
OperateLayer|positionallyWhthe
m_imagineResulting|cardArrowTold
wereNeedsNothing|controlsConvertible
resultsIncreasedScreen|allocatedWhtheAutomatic
omittedCorrectContext|skimSeparateOverRedefines
ostringstreamDirection|initializebyRequireEnding
messageSolvePassingSense|enumerationRecognizing
UnToAttack|withfifthAskedValuelike
detailSpecification|omitsThumbDecide
m_collectionExpectations4|m_occurWithoutObvious
involveBracketsKnew|unwindingColonSource
m_relativeChosenWroteInfer5|m_selectsModelMatch
timesOnceWhole|encapsulatesFullInversely
VisibleRole|enumsEqualRequiredShared
oargumentsApplicable|loopsManyRelational
onSuddenFinish|automaticConstsDirections
GenerateMD5|exerciseOnbitsMultiple
relocateContainer|handlesEnforceNoting
removeAllHandlers|fithatToolsContaiany3
_beforeDrawCommand|m_overallRelevant
space2Tile|preventIncrementsVectors
DataSource|relationshipMaking
autoMoveShow_ex|meanThpositionSelected3
m_promotionMultiple|onbitsVersusCorrectness
LuaEvent|findsGrammarGets
m_select_action|m_creatingPositionally
syncPosToServer|instantionBackslash
referenceAfterLifetime|swapConfidentQualifying
_scissorRestored|interactsKnew
WeaponEffectPosOffset|generallyBeginning
gradingPatternExplain|bracketCalculateContract
queryresultLeastEffect|reducePrvoidAbove
ride_inited|m_purposesGrasp
m_mapTextureList|m_memoryAccustomed
SpritePlayer|regularAlmost
hierarchyWantsBitsethe|implementationSimplify
ActorRenderType|argumentPart
fetchAsideThen|ofileSurprisingCalculates
OffsetPos|incidentalGoodPresumably
createBaseWithCache|manageHandleDeletes
m_pairDetailedSaid|tuplesAverage
linkingSupported|regexCompilersFreind
m_deducesUndulyIsbns|m_visibleUnordered
invalidFurtherExplicitly|externfifthCodeCentral1
limitTypeGiven|tellUpdatesCast
ActionHide|publiclyIntentFind
m_pszFileNameList|letterShownCmatch
incrementInstantiating|conventionsApplicable
cleanAsync|inferOperatesPostfix
YGirdView|modelProcess
AWC_changeActionState|actuallyEveryAppearsTools
m_defaultFileName|m_coutRest
MainNode|usedAbstractlyEasy
m_suddenDistance|m_charactershavingNested
onSubThreadEnded|lengthTakesErrormsg
m_clearIgnoreBook|m_aggregateDenotesSyntax
functionsNormally|declareVectorsWith
m_controlsUninitialized|headApplicableModel
removeSetActorVisibleCd|everythingChangesHeight
illustrateDecideWhose|priceSimplyFails
cczPlistFileDir|candidateKnewSubmatch
separatesRunsChanging|naturallyPresented
readThread|allocatesSmatchNull
thpositionRepresentCerr1|specializingFollowed
designerCompareisbn|worriesHoweveweTable
declaresUnderstandingPath|previousAnalogously
reliesExpansionPrevents|runningReferencesthFind
m_smalltobig|beginsContainsCars
redefinesProblems|suspendedWantedThdefines
updateCellAtIndex|abstractlyCompiled
CMD5|flagsFifthMachine
CacheNum|closeOargumentsSold
identifyingGuaranteed|tookIndicesLets
objectsthInterpretedWants|smatchConvenientVariables
JustDelayCheck|companionCheckApply
m_lettingIncidentalOthe|m_iathFriendshipRather
checkFlyPath|typeTogetherInstantiated
m_asyncEntryIdList|m_freesPscreenRely
SmallToBigMode|correctlyLockPointBasic
omittedMemoryWhyou|violateEmployeeLearn
illustratedNeedingScoped|requiresMatrixFileEvery
m_componentsAttrs|checksStorage
violationsPepperbyLimit|compareisbnKnewLarge
checkVisible|priceIdentifyTypcan
containerBlockInstantion3|designingWmustInevitably
m_variablesWhifRealizing|m_readsWordsAlready
m_nonvariadicCallingStudent|m_forwardInform
suspendedLoothHappens|statementsSmallerDeclare
m_versionChannel|precedenceImportantAgain
m_takingPresumably|m_specializationsAttempt
registerGotoDeathCb|leavingOmittedFunctions
formThingOughtTemplates2|boundthatAkinRely
madeRuntimeFairly|functionWantedReimplement
removeActionChild|prefixedSeriesInheritance
bypassSomeHoldBasic|preventProperlyCompares
m_presumablyReferDerived|m_elementCorrespondCovering
TimeLabel|saveProgrammerReferring
keywordArgumentsStatics|expansionDefaultsActs
elementQualifying|sufficientlyLatest
deallocatingCommonly|mustColorPreferredAkin
m_onRide_id|supportedReason
CurrentActionState|writeProblemStatics
figureGradesDesigner|coversOperandsCovered
m_ableFoundDoes|forwardingOstringstream
identicalAppliesCease|containersDeclaresLetter
defaultsSketchRelevant|relativeParameteth
longtypSalesDeveloped|typeAdvanceEmbodies
partialCareEqualityElem2|valueNumberDescribing
isDownloadingOrJob|elemtypeConcludesCard
includingOperationsAbout|somewhatChoiceComputing
packReversesLatest|arrowElemeisDescribed
largelyZeroAdvantage|wmustContadeclarations4
m_differsPreviously5|m_rulesQuery
addCallBack|usersApplication1
LuaSocketState|partnoTreturn
m_swallowTouch|m_abstractionDisadvantages
LoadALL|deletedAnotherEnclosed
ResLoadStatus|destroywhenExistingWell
previouslyInttypesAend|alternativelyDiskOfile
m_boundthatLocalSwapped|handledModify
rejectDirectionsLocal|destroyInsertSlowOpposed
m_recognizingWordsIndicates|m_stringthFlips
exchangePositionedTime|relativeReimplementIgnore
makesSpecifedAble|overCompoundIsbn
listthInitialized|introducedSimilarly
m_savedCopiesFigure|violationsChanged
m_spaceRelySomewhere|m_digitsSaysEnsures
benefitDoubledRevise|everythingTriesIndices
m_touch_move_cb|m_supportChain
flyTmpHandler|copiedBitwise
ConnectIpv6|versionLeftItas
syncNameAndBloodShow|itselfReadMoves
applicationOnExit|predicateWhversionChose
effectivelyCompatible|localSyntaxViolations
m_actionHide|problemsAsfifthRepresent
hurt_kneel_inited|m_avoidPredicateBetter
charactershavingIntroduce|areaLoopsPositioned
Commen_Direction|inadvertentlyExist
m_linkageImplementing|forcesOverheadDefinition
othePassSpecifiesFeature4|manyViolateRest
currentAllowsRegexThing|indicatesActsDoeth
compileSaveHiding|coversSurprisingExit5
m_referenceOwnsValueduring|m_describedAddressReject
anotherEntire|controlsInitialize
m_components|incrementRather
maxcut_stand|suppliedShaking
mubeDealingQueryresult1|elemAdvantageHere
digitsPeriodThemselves|presentedPushedSuppress
externfifthCarsTold|applyChapterSolution
translateProperAssumes|exclusiveCharbitsArgument
m_setWhiteCb|decideListitem
pszFileName|candidateCalculated
BloodType|expandingAroundLike
remainderDesignsWhether|companionDoneDeclaration
syncSendStateWithChildren|morePrintedTransfers
implicitlyExpanding|generatingDeducedFairly1
separateExecutionChain|bindingEquivalentAlegal
addTextureSprite1|directionResolutionFind
MsgID|doesndifferGuideNontype
_blurSampleNum|bookstoreSaidBefriend
_plistInfoMutex|askedAdaptors
cleanDenpendFrames|wcouldUnwindingGreatly
addPhantomMoveEffect|fullyClosesMacro1
SpriteMonster|uninitializedWish
leavingWhicheverTuples|exceptionsDefiningReflect
m_time_label|temporaryFromExecuting
m_rotateDrct|m_obviousArgsLogical
grantsDeclaresBrown|bitsWhicheverReport
LeftTime|handledFuntionOperate
doneCertainProcesses|undefinedExclusive
AsyncJob|imageElementIncrements
carsInstantiateRationale5|equalityTemporary
possiblyArraythe|processIncrements
_deltaTimeTmp|freindRestrictions
letterInevitablyWcould|findsBeyondContents
initRideStatus|exitChangedConversions
m_scopesItemRunningErrormsg|containerWhappears
exonlyReviewDistinctive|increasedOccurrence
partiallyPreferDevoted|createInitialization
ActorFlag|unnecessaryTransactions3
registerTouchDownHandler|lockComparesProgramming
unscopedDelegatesBegin|thpositionFullMany
restrictedEntireVariadic|machineRecompiling
m_resSuffix|distinctiveRvalue
alsoRecursionSeries|curtokFollowedOmitting
overReverseMust|sequencesNodtorLonger
m_resultSystemsPreprocessor|m_initiallyAccessPeppers
EntryId|managerTheseClauseSkip
updateJoystick|unusualSafeWhole
resetDisplayGap|m_quizaEvaluatingElsewhere
m_fifthSeriousOverloading|m_reversesConvertible
fromStatementConstexpr|overloadingTurnVariable5
playerAttackToPos|specifyRemovedMissing
PositionFromIndex|jumpingWhisTranslate
hideAllActionChild|temptingVariabandBeyond
familyAuthorsReview|meddleContainedSequence
LuaEventExEx|variablesFundamental
m_facilityAuthors|m_createWithOrdianary
initWithFileExt|ceaseFacilitiesSupply
m_existsComplexityThose|actsWcouldGets
ActorRenderQueueManage|extensioindicating
theyRelationalPredict|abstractlyEvaluates
collideCurrentArticles3|namesPointsTypcan
tediousPreventsCmatch|randomBecauseTries
popLongLong|lineBetweenQualifying
cczPlistData|endsConvertingIncidental
qualifyManagerWords5|underDynamicallyOver
kindsPassesLeaveAffects|enforcesVectorsClose
m_wcouldIllustratedConswhat|assignmentLeft
m_selectObviousExtensions|amongIndicating
copiesFonumberHolds2|involveDifficult
removeComponent|implicitlyLibrariesErrors
m_thereNotifyChoice|m_scopesStopsThemselves
synonymExternfifth|primaryCalcRestrictions5
chosenWaysAddsOriented|whyouThemselvesGeneral
fundamentalPermitted|componentsForgetPerson
easyTookBasics|movesGrantsColonOfile
containerHappenFixed|neitherHighAttempted
convertsTextLearn|toldBypassWidthPreserve
_DisplayNode|temporariesHandles
flyToTheDir|encloseMessageFigure
changeMode|presumablyActually
girdCellWillRecycle|movementPartProhibit
compilingSimplify|appearsParts
heldRepresent|simplerFindsCombine
pointerlikeChoice|supportRightOrdianary
dir_next_tile|m_messageBackslash
defininsideSensible|pointsunlikeFunctiwith
_asyncStructQueue|m_imageAdvancedPreserving
CenterItem|unlessNumberedLimitsTakes
m_synthesizedWhereSupplies|m_levelRegularReasons
m_wholeFindingBuilds|m_arrowLetterMight
CenterPoint|promisePlaceContainers
FatherType|matchesResetWere
determinesPrinting|accustomedThposition
movingValueWregex|meanStrblobObviousCmatch
m_promotedOperation|leavingEssential
isTouchMoved|forwardingVectors5
ShenbingStatus|otheContaianyAlphabetic
translateSurelyExecutes|applicableExecutable
ShortMode|completesActionsBind
VersionChannel|exerciseOrganizeLogically
checkMovePos|companionArrarecall
generalParametethatChain|goodNonvariadicWanted
StFPSlog|heldInvolved
callCurtokPrefix|firstCallpassShare
m_noMove_cb|actuallyDoingEvaluated
OnRideWithChildren|blueprintObjectsth
m_callExclusivePurposes|typeinfoProperly
RestoreFirstFrame|descriptionCleansNotify1
frameworkSolveStrings|errormsgSourcePrefix
initAttackRushStatus|specificationInitialized
replacementAliasDescribed|largestFunctionalthough
providesPushedExecution|exceptionsBecauseError
m_hasptrTimesFindbookTopic5|m_convertIncrementallyExit
pscreenEvenFront4|doesndifferFreedAggregate2
m_center_item|undefinedparameters
calculationArrival|preventMistakeSeparation
sequencesComplicated|comparesElements
m_authorsBeganGreatly|m_kindWithinConstitutes
CLuaParam|undefinedCoverFocus
performHandleReduce|destroywhenFamily
applicableMember|supplyingEffectively
unnamedBefriendCompiled|specificationCalledSlow
suitedExchangeDestructor|targetFunctionfunction
loothFonumberWere3|separationSeparatesOught
m_petOnRide|akinGeneratedRelease
themContainingChose|latestSourceEvery
occasionallyAbsoluteBlock|indirectVersusPreventing
MaxReadCount|facilitiesKidsFlag
m_chparameterDereferences|m_dereferences
m_comparingRepresentOffsets|m_cmatchLoothPartially
onceNonreference1|numbersRelevantTopicBegan5
_requestQueue|m_inevitablyNonconstPerson
m_suddenDistanceMin|capitalDigitsDescribes
maxcut_hurt|waysColorBinds
m_aroundBasicSets|m_printingEffectPowerful
_errorCallback|otherKnowFirst
m_takingWorryWhappears|m_conceptInadvertentlyIsbns
attemptPartiallyIntend4|icaseInteractsMean2
m_sufficientlyHighFrees|m_becauseSeriesSucceeds
m_isFixAnimDir|m_justConvertible
adaptorsFeatureLvalue|declarationAbstract
objecSuppliedIncidental|reviewValueDirect2
m_companionSelectsFree|m_computationalUnusualHelp
m_isBloodVisible|m_techniquesTimeTypically
m_compatibleExisting|m_tediousText
establishesWithElemtype|clauseCorrectPrograextern
m_show_texture_path|m_assumesAdaptorsSpecifier
m_thinkHighIath|cacallBitsethe
operationsThoseRelying|indexingStoringInvokes
addTopHeadNodeToMap|qualifyingMatchesResource
syntacticAssumesData|supportNonpointerSimply
dereferencesReportZero|difficultExecutionPast
asyncEntryIdCallBack|preventsFunctiopresented
m_syncPosGap|flaggedEveryChparameter
stopMapAction|wrongPowerfulEstablishes
ShowBloodAnim|containersTextquerySafe
theifProperEarlier|arrarecallUnlessWhenever
additionPasses|moreUnlikeCheck2
digitsSampleHandles|interactsRecursiveVersus
m_checkOpacityMoveDistance|m_thosmembersGreatly
cabeSymbolsBecomes|initializerTheyNotify
withErrormsgSome5|enableNonnestedFairly
_updateCellPositions|initialDistinguishBehave
m_suddenCheckGapMax|m_attemptedInitialized
m_optionalInsideHard|ellipsisOwhich
m_footprintsCb|m_definitionComparesTreat
preventsCacallSuccessful|dataRevisitedAllows
intendNeedingFinding|facedSmatchRunning1
wilreferFunctionsConcept|frameworkInspiredLittle
m_tildeBrownOutput|m_actuasizeWouldDeduces
m_actiontime|m_almostSeesManage
LabelChild|reallocatesExerciseSurely
wantBindSubset|neededBitwiseThought
m_bitwiseIntrinsicfifth|m_absoluteExpressionas
s_sendMsgBuffEx|reuseFull
_touchPoint|typcanDescription
addWeaponEffect|whisTemporary
libraryKindThese|datsuchCalculateSupplying
createEffect|istreamRestCompiling
equalChainDocumentation1|thatMatchingTransfers
m_indicatingRequireAkin1|m_readyMismatched
m_verifiesCouldFocus|informationEncapsulation
m_properAfterNocopy|typeinfoOtherwise
distinctMatchingPromotion|onceWhappearsMoreovesome
enforceTakesCould|impactDynamically
alreadyModelClasses|thoseLvalueBinding
is_getData|m_techniquesSwapContainers
unbindPlistAsync|passingFonumberBitvec
MOVE_CHECK_GAP|m_natureConstituent
m_calculatesPagePrimary|endingThusThose
sureIntrinsicfifthOthers|functiwithAddition
registerSetVisibleScreenCb|determineIncludes
yourNextOperators|longtypEnforcePrimer
freeUninitializedPeppers|occursMistakeArraythe
addColorGray|limitStaticsBriefly
PlistPath|convenientExclusiveGave
additionRevisitedSpeak|gradesWhetherCountsUnless
m_arrayPairwiseLetters|m_executionShared
randomFullyMultiplying|variadicPrefiNormal
referencesStringAbstract1|learnLeadsObject
termsCurlyCondition|nontypeArgumentobjects
equalityArgumentsOrganize|strblobSpecial
SocketData|schemaDealCompute
m_contentsShown|m_benefitSurely
actsHandleClosesPrefixed|freesCursorInttypes
m_referencesthRestInversely|synthesizedArticles
m_whatHelpfulMeddleIgnore|advanceLabels
overrideContentImagine|encapsulatesExecuteIsbn
returningDesignersRelying1|improvementsContaiany
processesSeveralEqually4|fithatApplication4
m_autoTime|m_providedDerivedObjec
wefifthWantFunctionality|mistakeHighAllocateTwin
relationalKnowledgeItas|sketchCircumstances
affectedSyntacticProper2|givenArrowWill
AsyncSpriteState|mistakeIobjClear
decideChoiceAssigning|debugdeleteProvidesPrvoid5
MAP_SPAN_X|m_declareTells
MAP_SPAN_Y|seriousSolve
convertRoleMovePosToMapPos|infrequentlyExpectations
m_conversionchapter|linkFullySupplied
m_relativeIobjAlphabetic|saidWish
m_refersTreated|m_downAutomatically
heightQuiteSequential|stackFiveMultiplying
m_operandUsesChanging|m_expectsOmitted
importantDeclarationSkim|patternMuchReuse
m_compilationReversesWhat|m_precededNecessary
m_eliminatedPrecedesMany|m_whicheverOccurrenceSays
updateTouch|swappedSoldDoes
callsVersusReason4|simplifyPositioned
argumepassed|groupDeletesResolution
checkSuddenDistance|lookingInstantiation
m_boPhantomMove|m_addressDefines
happenCalculatedIndexing|statementsAllocate
m_correspondDoubledAngle|m_peopleOverheadTemplates
WsThreadHelper|m_needPassed
m_carePropagatesAproblems|m_referSaysIstream
playActionData|oughtStopAvailable
s_sendMsgBuffExEx|unlikeDetailsFriendship
determineRespectiveUsers|whtheBindsAutomatic
curlyEncapsulatesBasics|boundArgumentDescribing4
m_simplyForwardThanTrivial|m_randomStructureMight
decideWhsuggestFollowed1|fundamentalPackInitialize
ScreenVisible|intendingAllowsTurns
addSpriteFrameListAsync|usefulContainsTotal
factEamightStatement|illustrateBrowsersOperand
m_managerInitNum|curtokDeduced
onMoveSpeedChangeAction|devotedInheritanceSelect
m_isLoadPlist|m_generateShowsDeleted
m_screenVisible|m_designerDoesndiffer
correspondsVersion|versusTheifConsts
removeSetOpacityCb|designedQuizaLegitimate
ODSocket|alegalPresentedCurrently
fullParticularProvided|knowCalculateProvided
m_fundamentalArrarecall|m_copiedLimit
tellBeingOccur|curtokHigherWorth
m_scriptSelectedHandler|m_alreadyIdentical
m_currMode|m_deleterDecrementsUpdate
declareBitsetWhat|nullCaltoDoubledTake
scrollViewDidScroll|groupFailAlternatively
m_enforceBecauseLogical|m_extentNecessary
SHOW_STATE|nameDynamic
m_actorType|declarationsOuter
changeState|alsoExtendedLogical
m_referringVary|m_readMatching
hasBlockAlong|findsOnbitsYield
_m_stand_time|fewerOargumentsBitwise
ownsImmediatelyAfter|benefitDecideAproblems1
isLoadFinished|questionSupportedSave
giveCastResponses|aproblemsWorriesHeader
knowSomething|largeInitialSpecification
understandingConverts|conceptDeclaresLearned
space2Screen|hierarchyReferencwhat
insertKnowSingle|operationsDereferences
isTouchInside|entireBuildsProperly
m_instantiatingUnder|m_requirementsUsers
actsIncrementingRoom|pointerlikeUnderstanding
NowActByDir|numericHiddenTchange
requirementsExtensions|stoprocessing
showAllActionChild|definitionOlderRepeatedly
affectedInspired|theseDefinitionImplicitly
separatorRepresent|testingDescribeContents
m_appearOverloadedBehavior3|m_predicateIntentTakes
RockerDirection|processesScopedBase
SpriteType|findbookComparing
m_moveKeyPosCb|m_contentsMinimal
OutLineSize|doneEnoughDerived
pushDouble|handlingDeletesTableDone
conversionsOstreamReused|featureCabeMacro
followedStackSuppress|enableAutomaticallyWorks
reachDifferArgs|externfifthIntuitive
IsAddRenderList|personCalculatedRemoved
m_scriptUnselectedHandler|m_orderItself
knewActsConverts|whisLabelsVariaband2
HideWithChildren|standardDifferentlyHave
lettersSufficiently2|incrementallyArgsExercise
MapSize|designsComplicatedIgnore
ColorWrite|publiclyHeldCompared
_sleepCondition|m_whenInformation
removeSyncChildActionCb|latestProblemRtti
referenparameter|styleQueryresultOthers
m_storedSeveralDeclaring|replacedIntent
_remainTime|cerrUnscoped
colorEitherIterators|oftenCombineRangeScoping3
m_longerReliesVersionSingle|m_matrixExpressionas
BasePosition|argumentDiffer3
m_presumablyReachAllows|argumepassedIcaseRuntime
PetOnRide|meaningTermsReset
largeSeveralPerformance|nestedEquallyBeyond
AsyncDownloadManager|followsDiscussionBrowsers
m_syncReplace|discussioofConceptually
ModeState|accumulateBraceDatabase
m_auxiliaryIllustrated|betweenWcannot
copulationNumber|zeroTellsZero5
ruleCacallCopyingTells|referencesthReally
queryresultAttempted|meansLockEnumerator
totalReuseBitsethe|rulesEnumeratorsAccessed1
m_expectAlgorithmDesigners|filesNewlineNesting
compilerAllocationLetter|harderConverted
listedEssentialCompound|savedConstraintsGive
m_wilreferUniqueBefore|m_comeTemporaryAttempted
m_minimizeSequential5|m_sharedYour
m_reset_display_cb|themGuide
ThreadSendMsg|purposeFriendshipfifth4
SeedRandMap|namingImportantSafely
errorCallback|m_queryresultAlphanumeric
cannotThenMeddle|denoteTopicsLimit
runningWorthSection|transfersContrpassesLoops
m_comparedArraysParentheses1|involveDisadvantages
base_url_backUp|m_partsDestroying
MainRoledata|lookupPoint
relyingConstantInttypes|throughPredicted
declaresEntireBookstore|generalFunctionfunction
m_instantiatesInvolvedReset|m_holdSwap
m_footprintsMoveDistance|m_callerQuestion
m_touchEnabled|substringNamespaces
createDownloadDir|anotherFunctionsSecond
m_isLoadTexture|m_witaParameters
maxcut_ride_stand|m_sufficientlyProperties
m_sharedFormCallable|m_preventsTook
HandlerType|viewDefinitionTend
_moveCellOutOfSight|performanceAssigns
m_designMatchWordSmart|largerSuppress
assignThrowsVectorsFails|wcouldExplainingImplement
m_bookFriendsSynthesizes|m_bindingUnorderedVaries
main_sprite|stylePattern
m_sendMsgCount|m_denoteParametethatSite
allocatedUnlikelyDetailed|remainsEitherLimit
m_referenceBrowsers|m_encapsulatesMismatched
addSpriteFramePlistCallBack|inspiredCccccccccc
machinesSupportNaming|groupedOughtInteresting
m_phantomMoveFrame|m_omitCompiled
initWithDataSource|symbolsUpdateBehind
indexingThoutermostIcase|whisChainSupported
whisPushedPointer|similarPowerfulMatter
isTouchEnabled|deletedGetsDecrement
inferListthRewrites|largerSaveWork
interactionFundamental|moreFlipCompanion3
stoppedAnimatedScroll|howeveweDoneRequires
m_couldAbilitySchema|m_subsequentIstream
typeidsResourcesSame|contractThexercises4
instantiatingOverall|worksFailPrevented
PlistPath2|delegatesPrintNone
AsyncDownload|otheDeclares
m_currActionState|m_savedLargelyDatsuch
m_constitutesInefficient|m_referencesthDeallocating
m_themPrecedenceAsked|m_cabeBlobptr
lessEvaluatingBypassWita|convertedCompatible
addSendMsgCount|presenceIntvaluesFree
leavingRealMismatched|allocatesPeppersIostream
loadSpritesPre|sequenceContrpasses
dependsLetsAgain|kindInsteadWork
update_pecent|happenSeparateBasic
ActionEnable|familyBackAssigned
m_alwaysConfusedThposition5|m_handleArgumentobjects
updateMove|listsImageRelated
identifiesSection|implementingAspectsTakes4
basicsRedeclaresElem|willPropertiesChecks
doubleprecSpecializes|showTpassPerson3
removeGotoDeathCb|limitedDenotesResource
m_checkOpacityGap|m_highestFewerAllocated
itasUsesWithoutLegal|behavesElementEnclosing
MonsterId|checkProgrammingUnchanged
encapsulateBecomesNest|theirPredictProvided
managedReasonEnclosed|assumeAssumingSeparates
textureKey|m_constructingInto
removeHandler|enclosingFramework
__indexFromOffset|soonQuizaNonconst
m_recompilingMoreSeparates|m_updateCallableAlmost
m_convertibleSafelyInside|m_resultingToldAlphanumeric
moveMapByPos|usableDeclaration
invalidReverseSplit|techniqueFriendship
IndexFromGroupAndInGroup|targetInvokesIndices
m_suitedVariousProperly|m_returnsDocumentation
otherwiseTransConstitute|facedGenerallyBookstore
m_actionOpac|m_forgetForgot
gotoRevive|appearUnusualLookup3
_isUsedCellsDirty|overallRunning
m_wregexPrecedenceConsts|m_writtenExpectations
ConnectNormal|easierEquallySignals
specializationsExecutes|defineWhicheverWhif
indicatedTpassPerson|providedPreciseUnrelated
expectsSomethingContainer|objecGreaterNonexistent
m_baseOffset|m_iathIncluded
m_actionOpac_c|m_hidingFindbookStyle
designedDoesndiffer|thumbFindNature
easiestBasisArraythe|guaranteedContinuesAssume
resetDisplay|whappearsExistsStrategy
m_tpassCompletelyAppears|m_operationsConsistent
incrementally|initializesFundamental2
conceptuallyEqually|wilreferMoreSenseAssigns
fixMapPosOffset|independentLegitimate
m_beginPoint|answerOptions
wordsPositionEfficient|pointerfifthGuideDenoting
m_needLoadTexturePathList|initializtheAccumulate
initMagicStatus|reallyEverythingHandles
strblobHenceMight|bitsetsPreprocessorBehalf
separateBitsetheDigits|outerWhicheverBeing
initRunStatus|tookAllocatesIathThathey
m_repeatPassRevenuePointer|m_forwardDoingPerform
DirByDirection|attemptsLettersSubmatch
callingExceptionLeast|makeConsistentIllustrate
m_notedRevisitedAccessed|m_thdefinesRespective
authorActualNone|debuggingWorksSets
run_inited|definitionAllowed
listFeatureExecution|synonymInstancePushed
ColorGray|nearlyFacilitiesSource
m_cardConstituteOnce|riseFeaturesVectors
changeImportanceLibrary|resultPurposeBecomes
SkillPhantomMoveEffect|graspFactorialStrblob
LUA_YGirdViewDataSource|assumeSystems
MainRoleId|differenbetweenSimple
determineEffectReads|operatorsConfusedHard
loadMapStr|somewhereInvolvedPeople
m_FatherType|m_typeinfoAnother
resolvesIndicatingGrasp|solvePrecedesObject
_callBackList|m_failStrcmp
m_occursCountFriendship|m_nonstaticLeavingStrategy
scroll2Tile|computeNumbersWhappears
updateAllAddMapId|promotionInvokesWere
gradingInstantiated|transformationLinkage
variousProgramTilde|filesFacedProvided
termsMultidimensional|analogouslyAccessTpass
LabelNodeC|problemsPreventing
LuaEventManager|distinctiveReport
waitCloseReadThread|bindsIndexingThoutermost
addHandler|longerPointsBegan
ComponentAttrsByTypeAndId|passedUnformatted
startRocker|smallerUninitialized
AsyncSprite|eyesBrackets
generalAsideOrdinarily|containsComponentsClose
m_facilityDescribesSection3|m_coupledWmustConverts
MapBackLayer|cabeOrdinarily
m_suddenCheckGap|m_programValidCccccccccc
imagethInherit|verifiesParametersunlike
m_articlesBindsScreen|m_stoppinconditionAuthor
maxcut_hurt_idle|m_carsRandomExplaining
constantReliesInvokes|theyConvertingConcept
m_chosenConstructing|m_thoughHelpReside
insertCellAtIndex|specializedReadExecutable
m_usedDelegateInfrequently|alsoRestRefer
closeSocket|alwaysPeppersComplexity
OCC_FLAG|pointerFollow
_needRelocateContainer|representsConditionPrefi
thosmembersResults|encloseFunctiocontrol
m_is_system_font|nonmemberUserTesting
nonnestedExploit|senseUnformattedRepeat
m_readersAlthoughTempting|m_propagatesWords
AWC_playActionWithChildren|recentSpellingRationale
m_stand_times|m_uniqueBothRevenue
girdCellTouched|separatorGenerates
m_TopComponents|thpositionAlong
NameAndBloodShow|theifAdvantagesAppears
moveMapByPath|matchStrictlyWhich
statementsDoubledPoint|throughDeallocating
arraysValuesEasy|nonreferenceBinding
m_bookstoreConcludesMissing|wouldEnumeration
resetSpeed|conventionConstexpr
m_conswhatFailsParametea|m_whisVaries
addCacheSpritesPre|sufficientlyReusedReasons5
logicalSlowWregex|longerDestroyedBook
ViewSize|asfifthRecompilingAssumes
LuaMsgBuffer|benefitImpactExplicitly
flipsPassLook|exitDereferencesTotal4
checksOptionsHandling|generatedBeginningExpect
ProtoBody|processesDefinition
logicalExclusiveRemoved|caltoDeducePositionally
equalButtonCould|saidPointGranting
m_enumerationsPlace|m_modifyAskedArea
m_thread_quit|enforceInfrequentlySoon
collideInTheDir|stringthCorresponding5
removeSetVisibleScreenCb|positionIllustration
relativeInvolved|inherentlyEndsVerify
ActorType|headerLocalManipulate
recompilingSaleListitem|appearLogicallyAssuming
Touch9Sprite|speakEasy
storeExpectsElipsisTreat|aspectsSimilarlyCause
m_lookOrientedArrays|m_enclosedRelative
expectationsReplaces|prefixedTheyBitsethe
conceptFoundPrompt|triesBehindCannot
hidingEarlierFixed|addingEnsuresEvaluates
referRelativeSpecialize|dealWhyouAsked
initDeathStatus|avoidIllustratedArticles
setViewRect|pathWefifthIterator
veryCtypeDefaultsBrown|combineHappensStored
SpeedRate|facedYourGetsMove
forestallDereference|introduceMultiplyingFree
writeObjectsSubsequent|includesSpaceRequested
updatePosition|includeNonpublicSuited
m_requireRevenueDecide|viewCtypeComes
tendsTypcanRedeclare|addedInvolvedResponses
initFlyStatus|powerfulBookWrittenReset
cczPlistFileWork|togetherThosmembersBinds
definingIncludesShows|thingReferencesthFurther
md5_finish|destructorBodies
move_speed|m_opposedQuite
YGirdViewCell|behavesDifference
DisplayMap|triesArrarecall
m_fallFreindUnique|correspondingReverse
m_functiocontrolVaries2|m_separateContract
maxcut_death|m_ableIndeedEarlier
m_explainsPositionally|soldMultiplyingInsert
showsSpecialization|decideFragmentHarder
m_sleepCondition|instantiatesPairwise
m_map_allAdd|m_wrongPrecedence
registerSetLocalZOrderCb|relationshipIterates
suddenToThePos|nonpointerGenericPartial
stringsPutsIndicates|privatecopyCoveredMade
m_asideSeparationAdded|m_whversionAsking
m_allowPreviouslyAlways1|m_checkUseful
m_alphanumericUltimate|whoseSpecializesLanguage
overrideFunctiwithMeddle|usableHarderModernSets
m_justDelayCheck|m_oftenGivenSymbols
attackOneTime|viceVisibleChangeFreed
m_touchType|positionsOrdinary
argsComparedColor|definePerformance
m_disallowTreatPrevented5|allowsExample
timeAgreeUnnamed|owhichDerivationArticles
pointsBitvecOstream|typeidsResolvedOlder
functionalityVectorFamily|instantiatesWilrefer
readySpecifiersMarkHide|hasptrSingleOnly
exonlyLegitimateCompilers|predictAuthorsDestructor
scopeDatsuchEllipsis|obviousDerivationWritten
classesBoundSynthesize|kindsKidsTransform
PlistsNum|constructThroughoutReduce
syntacticLargeRecompiling4|arrarecallImplementation
m_adaptorsWordLegal|triggerScopesAble
variousTurnEffect|figureDocumentation
m_worthOkayCentral|m_essentiallySwap
hidesMacroEveryTchange|asfifthNoteRanked
_addCellIfNecessary|wcannotContainView
stringthLvalueReuse|loothQuitePrefer
stopRocker|prefixedBracketsNodtor
MainSprite|ableRealizingSpecify
ActionStateChange|preferredArrarecall
groupCount|careCallpassVector
icaseTupleInitializers|quitePrefixedIobj
detailIsfifthLatest|objectExtendIntended
Commen_ActionToDo|labeledAlphanumeric
sendPointsByAstarPath|managedExpressionsState
correspondingReading|addingOpposedTold
girdCellAtIndex|localTechnique
cmatchLookupResetWstring|toldFileDealingSuppress
stopMonsterByPos|bypassSiteApplicable
identifyingAlternatively|meddleCertainWithfifth
OnRideId|bracketsCopyOmit5
flyTriggerList|instanceTransaction
exactlyOargumentsModel|programsOriginalNumbered
Tools|integralEnclosingBook
semicolonNumberedHaving2|figureCursorWhifWould
appearDownEqualsConverted|avoidMadeDesigners
resultSpecifedSpeak|realizingSpaceRule
largeBotherHave|turnsIllegalEssentially
HostValue2Big|neededSmatchWidth
createToTheDir|otheMubeDesign
offerTechniques|meddleManualPublicly4
YScrollViewDelegate|compilationTempting
_blurRadius|contentsTyhaveInitialize
MapView|muensureWhatRanked
ActorId|redeclaresWhifCentral
compilingWhereBest|positionsEspeciallyHaving
m_monster_id|togetherThumbMatter
TouchType|indexingOughtPossible
initAttackModeStatus|succeedsWholeScope
m_loadPlistEntryId|m_brieflyReside
identifiesSubmatchDigits|termsValuesAngle
DecodeBuffer|destroyDependsInstances
LoginEvents|tryingApplicable
SendMsgCount|freesValidApplied
m_ignoredLiteral|m_operationsNonmember
reusedStackOccasionally|topicsRemovedBoth
enumeratorsWregexKnows|allocateEmplaceStudy
contadeclarations|containsThgeneratesTake
m_show_plist_path|m_runningPrimaryReset
staticsExhaustedAhead|reallocatesCardVariaband
FootprintsOpen|guaranteedMemberwiseQuiz
occurrenceConventions|implementSubstring
expressionasProgramming|transactionsInefficient5
MakeNumbers|availablePage
updateShowState|ceaseCallableVector
suitedAssignmentUnder|treeBindingProcess
registerMoveKeyPosCb|scopesEachNote
approachResourcesListitem|indexedFlaggedShared
MapSpan|longtypDoubleprec
friendsCompileExtended|fundamentalEmployeeEntry
initStandStatus|randomSomeLock
ActionState|facilityQualifying
DirectionByDir|initializebyHenceStrictly
promotesValuelikeReduce|ableConfusionDifferent
thingCursorRatherWorth|encapsulationPreservePage
opposedUndulyConstructing|initializerInteraction
describing|findManipulateNonexistent
m_setOpacityCb|m_indicesBehaveStrcmp
detailedPrefixed|neitherRemainsEnumerators
predicateCacall1|revenueStringsFull
updateOpacityAction|howeveweOwhichProcess
applyTopicsPrevented1|hierarchyMultipleFreed
cczPlistFile|modelDifferenceMatching
_cellSizeIdentical|errorLooks
createWithSymbol|underWhtheConswhatCopy
squaresBitwiseInto|fullOargumentsLanguage
TouchSprite|functionfunctionShows
destroyingTaking|supportForwardMatching
ellipsisSame|referencesthSwapped
concludesDenoteEscape|movesProgramInstantiated
m_downloadListenerList|m_lvalueNonmember
howeveweDescribedWanted|pushedSpeakConsider
outerLettersAround5|parametisBestDefined
m_plist_loadnum|m_confusedThfunctionNested
m_exhaustedIgnoreInevitably|beyondOperating
looksAssignedInteracts|initializingSketch
m_viewRect|digitsInvolveDenotes
seenEnumeratorsExactHides|iteratorPositionedJust3
descriptionNonexternThing|everyDigitsComplicated
discussionCallIntending2|themselvesOnce
m_friendsSpecializeFront|m_worthEitherCall
reusedIntuitiveEither|everyReferencesDefining
incrementProcess|conversionSupplyingLikely
m_speedRate|m_largestEasiest
_componentOffset|indexedSelects
keywordEquivalentRelying|deducesLimitAffected
insertActionChild|soonConditionNamed4
girdCellHighlight|longerMadeInside
_direction|whenIndicesProvides
m_usableSharedRandom|m_overallLvaluePatterns
sub_pecent|featureSupply
determinesIntvaluesKnows|identifyingEnough
startingBuiltReset|manyNamespacesConfusion3
cellSizeIdentical|abstractExecutingAddress1
m_shenbingStatus|m_revisedBypass
md5_update|submatchStrvecCollide
isactor_flag|matrixSimple
NeedSyncPosToServer|lastBindNoteWhereby3
m_calcIncidentalSucceeds|m_contrpassesExchange
veryAllowedAssumeAnswer|topicsSeeminglyFacilities
focusOuterSyntax|detailsAbsoluteObjec
auto_download|m_putsAgainBegins
maxcut_magic|totalNames
stringthCopyingDerivation4|nontypeValuesStringBack3
m_isAstar2Finished|m_generateValidOccasionally
m_suddenSpeed|m_mimicAspectsSerious
functiwithMarkAffect|enumeratorsDisallowWould
inherentlyOstringstream|exampleAlgorithmNext
theifClauseAlgorithms|specifiersDeterminesBest
spaceApplicationsOperands|resourceDeductionSections
letsDecideKids|frameworkExerciseUnique
shadow_sprite|m_requiresSearch
getViewRect|ellipsisValuesSystem
invokesRepresented|yieldBoundNoted4
m_isInRenderList|m_offsetsMultipleHide
facedVerifiesVerify|capitalVariabandOthers
pointedHigherCopy|havingRecognizingPack
MapSendByte|imageLinkageUnderlying
BtnContainer|operationsDelegates
oargumentsFirstSearch|necessaryDestroyHold
m_gotoDeathCd|m_illustrationValuelike
sourceRelyTheseLearned|applicableOughtOwns
syncFlyStateWithChildren|lettersTemptingDoesValues
m_beginNode|underlyingEcmascript
uniqueBecomeItself|pointerProvidesAllocated
changeFullShortMode|greatlyAdditionSpecialize
maxcut_hurt_kneel|modernValidBased
hashFragmentChapters|withfifthSequential
fewerKindsOmitsThcall|encapsulationCopies
quizNestedDecrementsKnow4|shakingResideAble
sampleLettingUnduly|almostRepeatLegitimate
callpassDesignsBlob3|directionsUsedRequires
pdataComplexitiesBecomes|exactChangedHold
m_contrpassesSeparator|doubledCharacters
qualifyingSomething|understandingSimplerCabe
AsyncPvrPath|clauseHarderDeal
OutLineColor|goesDatsuchConversion
dependsStudentMarker|nonexistentDoingIndicate
m_title_label|m_priorIobjApplied
needCompilerFile|friendsQuizContinues
unnecessaryCurlies|differencePreferCommon
m_natureViableComplexity|m_replacesFriendsSection
m_thinkEvaluatedItself|asideWilrefer
sequenceAssumedSubmatch5|imagefifthParameter3
algorithmSeparator3|compilationPromotesDesign
onUIThreadReceiveMessage|stringsResolution
GraySprite|ideasDeduction
_cellsInGroup|m_distinctiveTrans
m_packScopesSyntaxCentral|m_rolesConsiderIdentical
yieldTransformPrecise|behaveAspectsReverse
addMapSprites|wideDiffering
yourDetailButton|conventionsThcallInvolve
m_prohibitInvolve|bookFunctiopresented
correctOstreamStrings|properlyElemElemeisExact
m_yourMuchAlgorithmMuensure|isbnsSymbolsAlso
_afterDrawCommand|matchedFunctiopresented
showsFacilitiesThanGrasp|redeclarePrivatecopyLets
readyValueFlip|natureWereSucceedsOwhich
m_applicationsIncrementing|m_intvaluesThemLetting
registerPlayActionWithChildrenCb|knownRolesWould
m_botherHenceIndexed|m_accustomedCompareisbn
languageUsersBinds|functionalthoughLatest
_indexFromOffset|similarlyReplacedWstring
indexingTyhaveTreat|unwindingParameters
m_violateUpdatesDeveloped|m_discussioofPromoted
maxcut_attack_04|riseMovement
MaxLineWidth|tpreviousFallMatch
addSpriteFrameListCallBack|positionallyBeenPrvoid
maxcut_attack_03|m_pastFithat
contentOnceSearch|togetherNaturallyMuensure
md5_starts|knowledgePreventing
bestContainingSaid|relationshipBehaves
transfersStartIsbnTrigger|omitsExceptionFacility
maxcut_attackmode_04|m_likelyGeneratesPartially
selectDefinitionWhat|ruleSeparationUnchanged
m_techniqueHiddenGreater|m_usefulDeducesHolds
combineIntendRoomSystems|everyCoupledDisadvantages
m_strvecCtypePlaced|lettersVersions
SpeedFloatPercent|interactionSeenRecompile
intendingContaianyWritten|intuitiveRequirement
typedefsLookupPublicly|regardlessInevitablyBase
identifiesQuestionMenu|consistentNeedingBitvec2
increasedElipsisOutside|allowedExpression
fundamentalEnclosing|regexNonePairs
_selfAdaption|scopeMake
m_targetPosList|m_isbnCalled
initWeaponEffFrames|successfulConvertedReused
registerAddTopHeadNodeToMapCb|improvementsSomething
AWC_setOnRide|entryEnumerationProblem
removeWalkCb|flipsTopicBehalfAbstract
m_curTargetPos|m_primerExecutes
AsyncCallBackInfo|bitsetWide
matrixSomeInterchangeably|encapsulationConstituent
seriesNecessaryHigher|invokesExecutable
thosmembersBoundPrints|aheadScopedSingle
pointedIndirectSimilar|numericBitvecCouldSold
hardestAlegalFixed|encountersExpands
moveMonsterByPos|isfifthSettingArraythe
detailedSaysArguments|thingOperandPresence4
m_treatedChparameterJust|connectionKnow
aggregateShareType|codeInefficientCount
stringDeducedGave|variousActualTilde
m_moverPoint|m_strblobStoprocessing
yieldsCabeInitialize|relativeClassesclick
blockIncludingDirections|arraysIsfifthFollow
redeclaresExplains|caltoThingsIncreasedPrefi
authorsImplementation|isfifthResource
getContainer|sensibleUsersFollows
expectationsView|mainConstsCompatibility
readyDenotesPeople|brownRequestedCollections
violateNonreference|doethReallyPrinting
wellConstituentEfficiency|indirectProcessDescribed
castIndependentBefriend|listDefinesQueryAttempt
violationsHashThosmembers|countsRepresentingLeave
m_flagLeastLiterals|m_choiceIncrementingHelp
haveTurnIndices|withBeginSimple
minimizeBeenFunctional|selectsEmptyOlder
m_isAstar1Finished|endingCalls
m_deduceDistinctBackWregex|m_presenceThrowsOtherwise
evaluatingCallpassIand|correctRecognizing1
IsResReady|disallowPointer
m_needLoadTextureList|m_periodShows
registerSpriteInitCb|correspondsEasierLetter
shorttypLocalExcept|constexprContentTarget
m_weaponEffectPath|m_refersAddress
rankedFunctionalthough|iandIdentifyingWholeAbove
m_incompleteEliminated|nearlyAlready
_setIndexForCell|consisWorries
plainListitemThen|lvalueSuccessfulTheare
preventChosenForces|sequencesIdentification
replacementExhasuting|typeidsArgsMimic
nonexternHappen|sequentialOccurRationale1
ParentReorderChildDirty|contentsInitialized
AsyncLoadPlist|conversionsThan
IsSystemFont|functionalSynthesize
prefiWhversionPrefixed3|relyApproachAllowsAgree
girdCellLongTouched|executedExpressionas
m_yourBeginningCoverage|assumesDeducedFactorial
calculateDeallocating|quiteGaveRemaining
SpriteDir|filesBlueprintSubmatch
numbersConfusedTheare|omitDuringInlinedQualify2
m_sequentialResolves|statementsAuthorsCease
updateBloodAction|inaccessibleLeaveThese
registerSetVisibleCb|sampleSameContained
pointsDesignedNonstatic|preferredTransfers
updateNowAnt|intvaluesValuesIobj
m_showNameAndBloodState|initialRelative
runningChangeSynthesize5|booksPointerfifthPreceded
executesWhereLooking|choiceNextCondition
m_expressionMakeChartyp|correspondLook
applicationOnUpdate|greaterOccurTellsOccur
bookPointerfifthScope|recordExpandedMatter
complexReferenparameter|algorithmComesSpecify
m_touch_rect|preventIncreased
syntaxTurnOperating|forgotPscreenSupplied3
cczPkmFile|knowSeesNonexistent
macroObviousCabePreferred|couldReturningThen
walkInTheDir|bindsErrorsAliases
m_isLoadPlisting|m_specifedAllocates
programmingPasses|ordianaryUnderBoundTell
constructingBecome|specializeHighDeduced
salesApproachThosmembers|specifyIndexedBlock
specializationPointers|calculateInheritance
registerRockerCb|destroywhenStylePeriod
initWithViewSize|nonmemberDifferences
akinBitsNonpublic|incrementsNormallyNewline
fragmentDecrementWorries|manyPrefixedValid
tile2Screen|treatedExtensionsRoom
m_inverselyCannotDelegates|m_controllingRightStatics
functionalConfused|somethingFound
_cellsFreed|bindsIncrementally
FlagValue|convertAliasesReplaced
resultsExhasuting|knowsTyhaveSimilarly
AWC_flyState|sectionAssumingOccurs
printForestall|memoryDistinct
lessParameteaPrevents|compoundDynamicallyDenote
preservingSetsAlthough|viceArgumepassed
deaccelerateScrolling|complicationAliases
m_delaytime|organizeReferredPscreen
m_blood_back|m_drivenGoodCompatibility
IsFixAnimDir|predictArgsSeparatorDeal
threedEqualsComputational|variabandException
EventGroup|numbersFamiliar
needAction|membersBracket
resolvedSenseClassclick|aboveThfunctionNonnested
m_compatibilityAutomatic|m_considerTotal
m_hideLibrariesTogether|learnIllustrated
indicateOfferCover|nonmemberIndexTogether
rangeSpecification|intrinsicfifthRationale1
interchangeablyMatchWorks|undulyResetAlternatively
m_setLocalZOrderCb|generalKindsStoprocessing
scrollViewDidStopped|parametethatBeginning
m_iteratorsOmittingBehavior|supportedWhichever
cleanAstarPath|seriesReachEntryIntending
witaOpenWhichPredicate|instantiationTreatRevise
cleanOtherActor|comparesOfferComplexity
understandingReject|beginsUndulyShouldParts
suppressPrecedesReverse|preferConnectionIsfifth
removeActionChildByTag|managedDeclaration
theirSeparateForward4|thoseBeganPartDescription
removeAddTopHeadNodeToMapCb|initialize
m_meanPrvoidMatrix|m_whyouPriorExactly
groupFacilityRefer|treatsButtonFlip3
partnoEncapsulation|intuitivePairsInstead
specifedIncludesInlined|designedSpecializing
m_programmerOuterBind|reliesFollowingDelegate
comparingOverStyle|removedBindAccumulate
DefaultActionPlistPath|asideMatchingRelying
checkCanWalkabledTile|delegatesLeaving
setContentOffsetInDuration|othersEverythingColon
initMapData|organizeImportanceMenu
m_eitherReallyPlaced|constantBitwiseStart
m_setActorVisibleCd|explicitlyDereference
registerSetPositionCb|referenceCompileTheare
helpPairsRemain|siteGiveFeatures
ResetDisplayGap|akinTemplatesExhasuting
wouldTemplatesAsking|digitsConswhatDiscussion2
m_constexprAproblems|specifyingNamespaces
patternInfer|filesDerivationExpansion
patternThirdDiscussioof|containingLabelsOrganize
m_onloadPlay|m_becomesAvoid
defaultsCombineBasis|coverInvokesNeither
iobjTimeProblems|deducedRedefinition2
BloodVisible|nodefaultQueryresult
m_ninesWhatUpdate|m_implicitIntend
m_isLoadTexturing|referencwhatReuse
sendPointsByPath|comparesForgetExtent
BaseUrl|viceTopicMoveBinds
followsStunninglyNormal|ignoreOpenAlternatively
m_spriteInitCb|m_coutCheck
m_showState|behavesIndependently
convertPositionsSpecifed|comparingOperationsSlow2
beganNotingReview|iobjFlipPart
registerWalkCb|printedOperatesEnough
intendingOverLetters|inttypesIntuitiveMeddle
suppressContainedInlined|parameterDoesndiffer
m_coveredSeveralTypically|listsEnds
databaseFreed|baseEssentiallyHard
m_membersOnalthoughIntent|saidConfusionOthers
m_leastInformSuch4|m_suppliesIndicates
m_restTime|m_nodefaultInteraction
omittedStrategyListitem|seenBraceRepresents4
currentlyEnough|triesDesignedVeryOften
start_tile|m_ulongAttention
m_stepTime|m_performanceSynthesizes
pepperbyPreprocessor|easyAbstraction
incrementallyBegunLets|sequencesFlipsReset
m_curliesAmongSpecificKind|m_informStatements
initializationPointers|soldCollectionAliases
_touchMoved|m_bindBrownExpansion
swappedPermitted|forgotCleansAccumulate
chparameterException|simpleTakingAssumed
VisibleCustom|forgetOverrideCommon
m_allocatedSaidSupported|overallStop
expandingAvailable|functiopresentedYour
m_plist_num|errorUnchangedWork
themselvesRequested|askingSomewhatOmit
restoreMainRole|variadicNodtorTimalthough
MsgBody|directlyIndicateWhere4
simplyManagedTwin5|ccccccccccPreceded
exchangeOpenOperand|performAssociativeWstring
m_sDirectoryName|directionsStill
m_resReady|flipOperatorclickConstant
_plsitInfo|m_generatingLikelyIdentify
initAttackStatus|legitimateVerifyFiveTheif
constituentTemporaryDeal|thexercisesRelying
involvePatterns|withPresentedWhatever
PrintPosError|grantingWantsPrior
ableAssigningConstructor|charactersTypedefs
goesBeingNearlyCursor|intendingTheseLibraries
m_needReleaseFrameList|m_requiresStatement
tile2Space|kindTableEssentially
solutionDifferingEndsUses|accessibleOuter
playStandEffect|prefixedPrefixedThough
addMoveTarget|namespacesPromotedWords
predictTupleAppropriate|afterCombineNonstatic
onSubThreadStarted|endsAffectRespective
removeFootprintsCb|compatibleEnforcesOnly
EncodeBuffer|conversionchapterSeen
simplerAdditionMain|sometimesAfterMatrix
accustomedNeededArgs3|fithatProvidesPositions
checkCanWalkabled|selectsScopeMeddle
MenuButton|blockOnalthoughException
fixAnimDir|pushedPairIndexingContext
calculatesGradingNontype|olderInstantiatesFuntion
callBackAction|greaterPushDetermined
countCopiedDestroyed|goesAlphabeticEnforces
m_renderListEntryId|specifiesSaveWould
instantiatingRevisited|readPubliclyContinuesHave2
extensionsBlockClasses3|representedTopicsAlso
_asyncRefCount|constructorOnbits
m_setPositionCb|sketchCalls
m_isFinished|m_fewerSpecifies
m_redeclaresDesignsSequence|m_preciseFlagSame
preventingLevelLine|surprisingConsists
m_screenChoseStart|m_colorInterpretedBookstore
wroteIathHappenDeleted|distinguishBasic
VisibleState|actualSupplyIgnore
CplusShowMsgID|varyingCollection
stopMoveAction|abstractlyBasicsArea
maxcut_attackmode_10|m_providedReflectCccccccccc
maxcut_attackmode_11|arrayDescribes
maxcut_attackmode_12|m_uniqueTreeSyntax
longtypOverload|pointerfifthInvolve
overallComplicationQuery5|buttonInteresting
duringHigherMube|bindsBeenInadvertently
parameteaCompanionReach4|beingAppearCreate
speakSpecifedNontemplate|facedReadingLvalue
printingSkimRecursive|loopItemColor
m_actionStateChange|m_ulongReplacesCertain
m_lettingVaryingDoing|soonChangedFive
withinReadsCarsWorries|usedIncrementsSurely5
m_move_direction|m_intendedRepresented
eamightBeforeEspecially3|suchSucceedsValue
m_transactionsSketch|contadeclarationsEntry
ZOrderFlag|tendAttemptsSeparate
removeUpdateTopHeadPosCb|initializationsCurly
m_appliedWrongBegan1|specifedPairwise
screen2Space|candidatePointerlike
careSomeSafely|evaluatesUsesAccess
m_declareTransItasCorrectly2|executedEssentially
m_othersProvideMuensure|m_getsPair
leastRestrictedExhasuting3|specifyingFacedIntuitive
ShowPlistPath|solutionCompatibility
NearTiled|questionBecause
Direction|operationProgrammers
appliedConstsWhatever|attemptedImagineBegun
MapScale|interpretedEasier
m_helpfulCorrectness|m_bodyTransactioUnduly
m_ableMarkerLinkPrevented|m_directlyBrowsersAround
m_doneTextComplication|lessOperate
m_naturallySmatchProhibit|timesPromotes
AsyncStruct|rvalueKind
variousThgeneratesFind|classclickRelySemicolon
m_rocker_direction|nonmemberSafe
cleansArrowProper|specifedCalculatedTreat
includesNormalPointer|smartDevotedFive5
specializationsProblem|orientedPromotionAuthors
LuaEventEx|comesExtendIntroductory
stringCurliesEqually|equalStrcmpPrecedence
andqueryVaryTightly|putsThgeneratesValuelike
PathByPos|nestingActualHappen
GroupAndInGroupFromIndex|questionFactorialTarget
playAction_ex|compilingWereErrormsg
specialProcessesCandidate|printedFonumberBrackets
positionVaryingPepperby5|shownIncreasedProvide
valuelikeStandardWhether|toolsSuppliesBotherIdea
m_unAttack|tyhaveOmitted
targetPoint|m_lettersIntroductory
playAction|whifSpecializingInherit
maxcut_ride_run|becauseHierarchy
MsgBodyLen|seesDescriptionForces
gradesWithoutSchemaThan|stringConstsBehave
synthesizesLessPrograms|dealingOlderBitsets
beyondExchangeWhversion|tpreviousStrictly
colonEveryLetting|ableUsuallyDelegates
ActionWithChildrenType|actsWordUnordered
grammarKnownHappen3|programmingChanges
enableIncrementingLock3|movingStrvecFour
m_fewerChoiceAccording|m_howeveweOthers
CenterNode|helpfulAliasGuarantee
registerDownloadSucCb|sequentialUnderstanding
m_addTopHeadNodeToMapCb|m_requiredExplains
althoughOmitRecent|parametersunlikeRealizing
compareExistOverhead|escapeSeenPointsunlike
m_arrarecallExchangeExpect|m_variableOmit
m_exceptionSeriesPrograms|unlikelyIntvaluesOften
_AstarNode|behavesTryingAmong
m_isAddRenderList|m_wroteAbstractActually
m_encountersEssentially|m_objecConvertingEmplace
reverseOnbitsEqual|doethSpecialization
iteratesMultiplyingCalc|writeExhaustedSold
maxcut_weaponeff_11|neededContainingListed
maxcut_weaponeff_10|predicateHandling
maxcut_weaponeff_12|likeText
hereWithAdaptors|brownAllocatedSerial
m_addedMovingBook|m_asfifthNextScreen
OpacityCustom|defaultsEitherFacilities
SpriteGuard|subscriptCastOther
_responseMutex|m_fifthPointerlike
commonlyCauseBitsethe|focusViolationsTypeinfo
cczPkmData|assumeThosmembersModify
confusedVersusSlow|rolesKnowTypeids
m_siteCopyingDoubled|unnamedImmediatelyTreat
m_pszFileName|justSomewhereSwapped
accumulateProgrammingLook|somewhatLockScreenAddress
_progressCallback|supportCopiedMatter
doStreakToTheDir|visibleRevisedPrecedes
respectiveExchangeMistake|charactersPromotes
initCheckFlg|includesInherentlyThing
m_isActive|m_incrementsBegins
YGirdViewDataSource|targetIncrementApplicable
registerSuddenDistance|largestExplainsViewWithin
m_optionalHeightResource|fithatTheifStrblob
calculateAssetPath|flagsChparameterIstream1
m_fly_mode|specializesIdentify
loadFlyTrigger|associativeEscapeDefining
m_pairWhateverNumberIstream|m_passesVice
objectsSwapPreventing|cacallLocalIntuitive
removeSetPositionCb|usuallyExternfifth
goodAsideActs|expansionStudyAttention
pushDataByString|normalExpectsCompilation
devotedArgsSynonym|modifyAkinConnection
FullMode|startSaysLimitDebugging
NameLabel|privatecopyStrictlyZero
actiontime|factSynthesizeRule
ShowTexturePath|evenRolesConstant
m_center_pos|m_iteratorsPromotionSynonym
argumentobjectsQuery|hardComplication
pdataSaleDefining|emplacePromotesIncreased
questionCarsToldThumb|abilityTableQualify
typeinfoPrivatecopy|knewInitializeComponents
moveMapByTouch|aroundPageHard
requiredPreviouslyEnding4|undefinedAbstraction
m_numsCache|m_designedCannotText
m_enoughConswhat|matchStrblobProvided
m_name_label|m_knowsAdvantagesTransfers
m_copiedMajorCompound|m_identifyConstexpr
IsFinished|publiclyOperateWhich
whisChangedGenerally|foundStyleNewline
toldLargerPublicly|redeclaresViolateExploit
removeSuddenDistance|blobptrKindsWhereby
AWC_conveyState|arrowCopyCircumstances
rocker_loop_max|advancedFindAround
notingQuizThings|graspIncreasedMacro
successCallback|m_plainHasptr
m_nothingQualifyingQuery|aboutBackWhappears
m_leftUnderstandingItem|markNull
illegalRttiClause|timesPredictIncludeThree
elemLearnCompatibility|usuallyDisadvantagesAble
m_overloadCoversResources|othersFourWhen
m_OnBodyComponents|m_requirementIllegal
ShowLayer|thatheyActualEnable2
maxcut_attackmode_09|escapeConflictEasy
maxcut_attackmode_08|m_smartCast
maxcut_attackmode_07|m_unequalPointerfifth
m_footprinsOpen|timesIndicate
maxcut_attackmode_05|m_ellipsisBefriend
m_componentsLargerThose|constructorsAverage
maxcut_attackmode_03|m_streamMoveEscape
maxcut_attackmode_02|m_determineExhasuting
maxcut_attackmode_01|m_generatesHidingRecent
m_funtionMakesDestructors|m_cleansVaries
otheAppeaanywhereVarious|browsersSimilarly
smatchUsersSubset|enumeratorsIndeedUnscoped
runLuaFunc|consultBetweenDiffers
whappearsPartiallyCeases|strcmpSystemsTuples
_container|m_manyInstance
m_conveyState|m_indexArrayForwarding
showNameAndBlood|abstractionContained
m_nameSize|illegalNoteSerial
SuddenSpeed|takingSupportedPack
s_recvMsgBuff|m_addedPreceding
programmingAproblems|alongOnalthoughWefifth
ordinaryAlegalAbstraction1|hiddenRecursiveMeans
DirByNowPoint|memberwiseAppearsSuited
m_sudden_cb|m_performJustPartially
placedSimplerSpeak|typeinfoFacilities
m_alwaysIobjAlmostOkay2|m_delegatesKids
missingResetReferring4|iteratorInspiredRequested
addComponent|exclusiveInitialCast
m_managerList|m_boundthatFriendshipfifth
m_memberwiseBitsOutside1|parametethatCollide
pairFiveZeroMoreovesome4|forcesPrefixMinimize
doOpacityAction|staticsOftenPlace
m_sectionThumbSyntax|m_soonAttempt
illustrationAvailable|rulesRecentlyArray
m_random_mode|averageInitializer
sendSocket|delegateFunctiopresented
moveViceUnable4|essentialPriceSerial
elsewhereOperatorclick|undefinedOwhichParameteth
initDependTexturePathList|learnNotedEmployee
respectivePositionally|rationaleComparingErrors
assumedConsistsCompiled|instanceOmittedCast
addRenderListCallBack|confusedInspired
AttackModeWithChildren|resolvesAcrossDesigned
m_nodefaultTransactio|m_thinkHappen
safeIndicatedIncomplete|matterReuseAccustomed1
registerTouchMoveCb|dimensionTheseAvoid
removeSetWhiteCb|decrementsFriends
m_is_right|findAble
m_setWhiteComponents|withWellOthers
includeNearly|itasComparingDiffering
m_manualAboveIndex|m_friendshipfifth
versionPresumablyTempting|greaterComputational
_m_move_time|m_deallocatingWaysShare
m_isAutoMove|recursionKindsWhich
_objRender|recompilingActuallyCannot
managingRevenueTheare|stunninglyLimitedPart
m_synthesizedChoseExit|m_constantEstablishesRely
m_saidRequirementSold|m_fundamentalIntroductory
findTriggerByPoint|signalsListthLearnReady
onAfterDraw|knowAttentionRanked
m_strblobSubstring|readyRightSpecialize
_successCallback|discussionIteratesAgree
hurtIdleToPos|reasonOutputThus
pathMakeMovingOfile|repeatedlyThcallAlong
storesOpposedJavaVice|lookupUninitialized
checkPatternWregexNocopy|modernFreindWhappears
print_storage|withfifthMismatched
definitionsEnds|classesclickExploit
conditionVectorProhibit|prohibitGradesSuspended
initHurtStatus|wrongVariousSame
initHurtIdleStatus|unchangedRemainGuarantee
initGLProgram|pointedDefineRegardless
SpriteBlur|thexercisesVaries
benefitWhversionOnce3|obviousStoringDone
roleMoveOnMapByPos|packInterchangeably
MoveDirectionUpdate|designingReleaseReduce
m_properOccurPromotion|factSaveResources
bookstoreFourRevise|identificationKindsEnable
girdCellSizeForIndex|booksIdenticalConstituent
pointersWarrantPeriod|redeclarePointerlike
operationContextCapital|treeConsisPassing
PageIndex|failsSomeUses
handleOperatingUnderstand|expandRecentlyExtent
typcanSurprising|staticsInstantiateProvide
closesVariesSketchSupply|iostreamUnwinding
DirByNewPoint|surelyLoopsSenseAllocate
scopedInevitablyStores|fetchMustSquares
ThreadLogFunc|unlikeReadersAppear
sufficientlyViolations|independentlyReleaseKnew
m_boSkillEffect|m_provideSerialInstead
